stateName,date,positiveIncrease,deathIncrease,positive,death,population,interval_start,mean_rt,std_rt
Alabama,2020-03-08,0,0,0,0,4903185,2020-03-02,5,5
Alabama,2020-03-09,0,0,0,0,4903185,2020-03-03,5,5
Alabama,2020-03-10,0,0,0,0,4903185,2020-03-04,5,5
Alabama,2020-03-11,0,0,0,0,4903185,2020-03-05,5,5
Alabama,2020-03-12,0,0,0,0,4903185,2020-03-06,5,5
Alabama,2020-03-13,5,0,5,0,4903185,2020-03-07,30,12.2474487139159
Alabama,2020-03-14,2,0,7,0,4903185,2020-03-08,9.4023332937435,3.32422681549104
Alabama,2020-03-15,4,0,11,0,4903185,2020-03-09,5.47431380425211,1.58029827425672
Alabama,2020-03-16,18,0,29,0,4903185,2020-03-10,7.58087740594354,1.38407252030551
Alabama,2020-03-17,10,0,39,0,4903185,2020-03-11,4.9380496436884,0.780774203651913
Alabama,2020-03-18,12,0,51,0,4903185,2020-03-12,3.55050401307175,0.492366318187341
Alabama,2020-03-19,27,0,78,0,4903185,2020-03-13,3.54099259474515,0.398392792561641
Alabama,2020-03-20,28,0,106,0,4903185,2020-03-14,3.09048561902702,0.306003674228435
Alabama,2020-03-21,25,0,131,0,4903185,2020-03-15,2.64659228652932,0.236718410456247
Alabama,2020-03-22,26,0,157,0,4903185,2020-03-16,2.30997315226882,0.19052337446903
Alabama,2020-03-23,39,0,196,0,4903185,2020-03-17,2.06003253984598,0.158934960964576
Alabama,2020-03-24,46,0,242,0,4903185,2020-03-18,2.03284115565505,0.142327349212812
Alabama,2020-03-25,139,1,381,1,4903185,2020-03-19,2.72088701824451,0.149553476032853
Alabama,2020-03-26,136,0,517,1,4903185,2020-03-20,2.77690448513669,0.132383727024306
Alabama,2020-03-27,70,3,587,4,4903185,2020-03-21,2.2385055941521,0.101961135861883
Alabama,2020-03-28,107,0,694,4,4903185,2020-03-22,2.04031358666947,0.0859127003295906
Alabama,2020-03-29,131,6,825,10,4903185,2020-03-23,1.9793335857511,0.0765254575662795
Alabama,2020-03-30,74,0,899,10,4903185,2020-03-24,1.72705801748292,0.0650909481268851
Alabama,2020-03-31,88,13,987,23,4903185,2020-03-25,1.56412741091354,0.0572667732733465
Alabama,2020-04-01,73,4,1060,27,4903185,2020-03-26,1.26243792160187,0.0484122843230939
Alabama,2020-04-02,173,5,1233,32,4903185,2020-03-27,1.23326437811633,0.0460571021835833
Alabama,2020-04-03,262,6,1495,38,4903185,2020-03-28,1.48891983554443,0.0493843536536016
Alabama,2020-04-04,119,6,1614,44,4903185,2020-03-29,1.39172455636844,0.0458588833035544
Alabama,2020-04-05,151,1,1765,45,4903185,2020-03-30,1.29869295557741,0.0423361804010775
Alabama,2020-04-06,187,4,1952,49,4903185,2020-03-31,1.35860562244966,0.0418478453528418
Alabama,2020-04-07,217,15,2169,64,4903185,2020-04-01,1.42296454293555,0.0413715418139577
Alabama,2020-04-08,159,2,2328,66,4903185,2020-04-02,1.40486989607173,0.0394371293941777
Alabama,2020-04-09,375,4,2703,70,4903185,2020-04-03,1.49522641017629,0.0389852768814141
Alabama,2020-04-10,244,10,2947,80,4903185,2020-04-04,1.34440884018442,0.0352694390477158
Alabama,2020-04-11,270,12,3217,92,4903185,2020-04-05,1.36486134763651,0.0340789615798984
Alabama,2020-04-12,346,1,3563,93,4903185,2020-04-06,1.4235920022481,0.0335637098290718
Alabama,2020-04-13,171,6,3734,99,4903185,2020-04-07,1.29818095775077,0.0307439427579178
Alabama,2020-04-14,219,15,3953,114,4903185,2020-04-08,1.2085839710092,0.028606038568212
Alabama,2020-04-15,122,4,4075,118,4903185,2020-04-09,1.12551947343184,0.0269204490115839
Alabama,2020-04-16,270,15,4345,133,4903185,2020-04-10,1.02323757323489,0.0252439724373665
Alabama,2020-04-17,226,15,4571,148,4903185,2020-04-11,0.99865484247838,0.0247735776666067
Alabama,2020-04-18,141,5,4712,153,4903185,2020-04-12,0.918593701992296,0.0237496747703585
Alabama,2020-04-19,176,4,4888,157,4903185,2020-04-13,0.823246214414937,0.0226077832262391
Alabama,2020-04-20,191,6,5079,163,4903185,2020-04-14,0.862895632400967,0.0235199146186302
Alabama,2020-04-21,238,20,5317,183,4903185,2020-04-15,0.907490351356112,0.0245626766180035
Alabama,2020-04-22,276,13,5593,196,4903185,2020-04-16,1.0353623471098,0.0265652238656866
Alabama,2020-04-23,239,6,5832,202,4903185,2020-04-17,1.01807095202094,0.0263922599763482
Alabama,2020-04-24,194,7,6026,209,4903185,2020-04-18,0.989384589926757,0.0259289215826638
Alabama,2020-04-25,0,0,6026,209,4903185,2020-04-19,0.893750449146364,0.0246463945542589
Alabama,2020-04-26,395,10,6421,219,4903185,2020-04-20,1.0586861840255,0.0270305302816166
Alabama,2020-04-27,118,9,6539,228,4903185,2020-04-21,1.01178635430235,0.0264705953989538
Alabama,2020-04-28,211,14,6750,242,4903185,2020-04-22,0.984449746295213,0.025996745088889
Alabama,2020-04-29,162,14,6912,256,4903185,2020-04-23,0.907828810557153,0.0249871656340297
Alabama,2020-04-30,176,16,7088,272,4903185,2020-04-24,0.87656580709883,0.0247238947960489
Alabama,2020-05-01,206,17,7294,289,4903185,2020-04-25,0.908197726552864,0.025494682004158
Alabama,2020-05-02,317,-1,7611,288,4903185,2020-04-26,1.16294837520404,0.0292017477256603
Alabama,2020-05-03,277,2,7888,290,4903185,2020-04-27,1.06277730683944,0.0277382619199763
Alabama,2020-05-04,224,8,8112,298,4903185,2020-04-28,1.11110832602433,0.0280061904592723
Alabama,2020-05-05,325,17,8437,315,4903185,2020-04-29,1.16980463161526,0.0284725992433238
Alabama,2020-05-06,254,28,8691,343,4903185,2020-04-30,1.19448732900568,0.0283120649546666
Alabama,2020-05-07,355,26,9046,369,4903185,2020-05-01,1.26295925580552,0.028534621885679
Alabama,2020-05-08,339,14,9385,383,4903185,2020-05-02,1.28256786399299,0.0280413884708754
Alabama,2020-05-09,283,7,9668,390,4903185,2020-05-03,1.18979720006591,0.0262270991065268
Alabama,2020-05-10,221,3,9889,393,4903185,2020-05-04,1.10295733376849,0.0246505535488877
Alaska,2020-03-08,0,0,0,0,731545,2020-03-02,5,5
Alaska,2020-03-09,0,0,0,0,731545,2020-03-03,5,5
Alaska,2020-03-10,0,0,0,0,731545,2020-03-04,5,5
Alaska,2020-03-11,0,0,0,0,731545,2020-03-05,5,5
Alaska,2020-03-12,0,0,0,0,731545,2020-03-06,5,5
Alaska,2020-03-13,1,0,1,0,731545,2020-03-07,10,7.07106781186548
Alaska,2020-03-14,0,0,1,0,731545,2020-03-08,6.05747589181412,4.2832822799758
Alaska,2020-03-15,0,0,1,0,731545,2020-03-09,3.66070465155515,2.58850908303578
Alaska,2020-03-16,0,0,1,0,731545,2020-03-10,2.82170413630682,1.99524612928469
Alaska,2020-03-17,2,0,3,0,731545,2020-03-11,4.81424250839074,2.40712125419537
Alaska,2020-03-18,2,0,5,0,731545,2020-03-12,5.07207962603345,2.07066783642475
Alaska,2020-03-19,3,0,8,0,731545,2020-03-13,4.62826943498696,1.54275647832899
Alaska,2020-03-20,3,0,11,0,731545,2020-03-14,3.49858213435943,1.05486220344645
Alaska,2020-03-21,2,0,13,0,731545,2020-03-15,2.78911889286015,0.773562398582509
Alaska,2020-03-22,5,0,18,0,731545,2020-03-16,2.858101945723,0.673661089047734
Alaska,2020-03-23,12,0,30,0,731545,2020-03-17,3.56483027596455,0.650845985274383
Alaska,2020-03-24,4,0,34,0,731545,2020-03-18,2.63142096776591,0.465173902615935
Alaska,2020-03-25,7,1,41,1,731545,2020-03-19,2.22145951005237,0.365205693792464
Alaska,2020-03-26,15,0,56,1,731545,2020-03-20,2.34212702805633,0.334589575436619
Alaska,2020-03-27,2,0,58,1,731545,2020-03-21,1.82646036058022,0.263626845211292
Alaska,2020-03-28,27,1,85,2,731545,2020-03-22,2.31029451644645,0.270399520565822
Alaska,2020-03-29,17,0,102,2,731545,2020-03-23,2.19470995574883,0.238049717739878
Alaska,2020-03-30,12,1,114,3,731545,2020-03-24,1.74862150558169,0.189664631878692
Alaska,2020-03-31,5,0,119,3,731545,2020-03-25,1.49683110505639,0.161407449075398
Alaska,2020-04-01,13,0,132,3,731545,2020-03-26,1.43231471033763,0.14932913128569
Alaska,2020-04-02,11,0,143,3,731545,2020-03-27,1.25313609369443,0.133584756433362
Alaska,2020-04-03,14,0,157,3,731545,2020-03-28,1.33482490503355,0.133482490503355
Alaska,2020-04-04,14,2,171,5,731545,2020-03-29,1.09391245794812,0.11727972581814
Alaska,2020-04-05,14,1,185,6,731545,2020-03-30,1.0153878465506,0.11078789682277
Alaska,2020-04-06,5,0,190,6,731545,2020-03-31,0.925485052910235,0.105468810134429
Alaska,2020-04-07,23,0,213,6,731545,2020-04-01,1.15447456762033,0.118446591441132
Alaska,2020-04-08,13,1,226,7,731545,2020-04-02,1.14294718051304,0.117263906478314
Alaska,2020-04-09,9,0,235,7,731545,2020-04-03,1.08300136344642,0.112302009922112
Alaska,2020-04-10,11,0,246,7,731545,2020-04-04,1.02643986145131,0.108196261445793
Alaska,2020-04-11,11,1,257,8,731545,2020-04-05,0.984006006783465,0.105496517422824
Alaska,2020-04-12,15,0,272,8,731545,2020-04-06,0.997518692319695,0.106335849890335
Alaska,2020-04-13,5,0,277,8,731545,2020-04-07,1.00173793902785,0.106785623100665
Alaska,2020-04-14,8,1,285,9,731545,2020-04-08,0.832511738161187,0.09743812888863
Alaska,2020-04-15,8,0,293,9,731545,2020-04-09,0.794271905072735,0.0963196164728073
Alaska,2020-04-16,7,0,300,9,731545,2020-04-10,0.808539037351394,0.0995242756225775
Alaska,2020-04-17,9,0,309,9,731545,2020-04-11,0.822807100179591,0.102850887522449
Alaska,2020-04-18,5,0,314,9,731545,2020-04-12,0.779620943651359,0.102369245093591
Alaska,2020-04-19,5,0,319,9,731545,2020-04-13,0.677661140472894,0.0978119604678436
Alaska,2020-04-20,2,0,321,9,731545,2020-04-14,0.6803510041453,0.101420739588609
Alaska,2020-04-21,8,0,329,9,731545,2020-04-15,0.73717054675829,0.109890896904148
Alaska,2020-04-22,6,0,335,9,731545,2020-04-16,0.756269370248713,0.115329997749268
Alaska,2020-04-23,2,0,337,9,731545,2020-04-17,0.71091961093228,0.115326389595163
Alaska,2020-04-24,2,0,339,9,731545,2020-04-18,0.619941842659258,0.111344841889851
Alaska,2020-04-25,0,0,339,9,731545,2020-04-19,0.566310117312907,0.111062551497059
Alaska,2020-04-26,1,0,340,9,731545,2020-04-20,0.531969069810704,0.11341618676267
Alaska,2020-04-27,5,0,345,9,731545,2020-04-21,0.678978343293395,0.135795668658679
Alaska,2020-04-28,6,0,351,9,731545,2020-04-22,0.690097866512535,0.143895352277899
Alaska,2020-04-29,4,0,355,9,731545,2020-04-23,0.681827054649353,0.148786861371402
Alaska,2020-04-30,0,0,355,9,731545,2020-04-24,0.668965502790709,0.15347121175682
Alaska,2020-05-01,9,0,364,9,731545,2020-04-25,0.996041781659615,0.195339864655235
Alaska,2020-05-02,1,0,365,9,731545,2020-04-26,1.07782877033363,0.207428243564148
Alaska,2020-05-03,3,0,368,9,731545,2020-04-27,1.14998499415085,0.213546852387378
Alaska,2020-05-04,2,0,370,9,731545,2020-04-28,1.01080078716537,0.198234343773507
Alaska,2020-05-05,1,0,371,9,731545,2020-04-29,0.809327675307395,0.17660977781518
Alaska,2020-05-06,1,1,372,10,731545,2020-04-30,0.716821643605632,0.168956481698276
Alaska,2020-05-07,2,0,374,10,731545,2020-05-01,0.851068179981349,0.190304630392532
Alaska,2020-05-08,3,0,377,10,731545,2020-05-02,0.630785265902226,0.168584453545088
Alaska,2020-05-09,1,0,378,10,731545,2020-05-03,0.677332427421187,0.181024705740144
Alaska,2020-05-10,1,0,379,10,731545,2020-05-04,0.637856000630108,0.184133166834005
American Samoa,2020-03-08,0,0,0,0,55641,2020-03-02,5,5
American Samoa,2020-03-09,0,0,0,0,55641,2020-03-03,5,5
American Samoa,2020-03-10,0,0,0,0,55641,2020-03-04,5,5
American Samoa,2020-03-11,0,0,0,0,55641,2020-03-05,5,5
American Samoa,2020-03-12,0,0,0,0,55641,2020-03-06,5,5
American Samoa,2020-03-13,0,0,0,0,55641,2020-03-07,5,5
American Samoa,2020-03-14,0,0,0,0,55641,2020-03-08,5,5
American Samoa,2020-03-15,0,0,0,0,55641,2020-03-09,5,5
American Samoa,2020-03-16,0,0,0,0,55641,2020-03-10,5,5
American Samoa,2020-03-17,0,0,0,0,55641,2020-03-11,5,5
American Samoa,2020-03-18,0,0,0,0,55641,2020-03-12,5,5
American Samoa,2020-03-19,0,0,0,0,55641,2020-03-13,5,5
American Samoa,2020-03-20,0,0,0,0,55641,2020-03-14,5,5
American Samoa,2020-03-21,0,0,0,0,55641,2020-03-15,5,5
American Samoa,2020-03-22,0,0,0,0,55641,2020-03-16,5,5
American Samoa,2020-03-23,0,0,0,0,55641,2020-03-17,5,5
American Samoa,2020-03-24,0,0,0,0,55641,2020-03-18,5,5
American Samoa,2020-03-25,0,0,0,0,55641,2020-03-19,5,5
American Samoa,2020-03-26,0,0,0,0,55641,2020-03-20,5,5
American Samoa,2020-03-27,0,0,0,0,55641,2020-03-21,5,5
American Samoa,2020-03-28,0,0,0,0,55641,2020-03-22,5,5
American Samoa,2020-03-29,0,0,0,0,55641,2020-03-23,5,5
American Samoa,2020-03-30,0,0,0,0,55641,2020-03-24,5,5
American Samoa,2020-03-31,0,0,0,0,55641,2020-03-25,5,5
American Samoa,2020-04-01,0,0,0,0,55641,2020-03-26,5,5
American Samoa,2020-04-02,0,0,0,0,55641,2020-03-27,5,5
American Samoa,2020-04-03,0,0,0,0,55641,2020-03-28,5,5
American Samoa,2020-04-04,0,0,0,0,55641,2020-03-29,5,5
American Samoa,2020-04-05,0,0,0,0,55641,2020-03-30,5,5
American Samoa,2020-04-06,0,0,0,0,55641,2020-03-31,5,5
American Samoa,2020-04-07,0,0,0,0,55641,2020-04-01,5,5
American Samoa,2020-04-08,0,0,0,0,55641,2020-04-02,5,5
American Samoa,2020-04-09,0,0,0,0,55641,2020-04-03,5,5
American Samoa,2020-04-10,0,0,0,0,55641,2020-04-04,5,5
American Samoa,2020-04-11,0,0,0,0,55641,2020-04-05,5,5
American Samoa,2020-04-12,0,0,0,0,55641,2020-04-06,5,5
American Samoa,2020-04-13,0,0,0,0,55641,2020-04-07,5,5
American Samoa,2020-04-14,0,0,0,0,55641,2020-04-08,5,5
American Samoa,2020-04-15,0,0,0,0,55641,2020-04-09,5,5
American Samoa,2020-04-16,0,0,0,0,55641,2020-04-10,5,5
American Samoa,2020-04-17,0,0,0,0,55641,2020-04-11,5,5
American Samoa,2020-04-18,0,0,0,0,55641,2020-04-12,5,5
American Samoa,2020-04-19,0,0,0,0,55641,2020-04-13,5,5
American Samoa,2020-04-20,0,0,0,0,55641,2020-04-14,5,5
American Samoa,2020-04-21,0,0,0,0,55641,2020-04-15,5,5
American Samoa,2020-04-22,0,0,0,0,55641,2020-04-16,5,5
American Samoa,2020-04-23,0,0,0,0,55641,2020-04-17,5,5
American Samoa,2020-04-24,0,0,0,0,55641,2020-04-18,5,5
American Samoa,2020-04-25,0,0,0,0,55641,2020-04-19,5,5
American Samoa,2020-04-26,0,0,0,0,55641,2020-04-20,5,5
American Samoa,2020-04-27,0,0,0,0,55641,2020-04-21,5,5
American Samoa,2020-04-28,0,0,0,0,55641,2020-04-22,5,5
American Samoa,2020-04-29,0,0,0,0,55641,2020-04-23,5,5
American Samoa,2020-04-30,0,0,0,0,55641,2020-04-24,5,5
American Samoa,2020-05-01,0,0,0,0,55641,2020-04-25,5,5
American Samoa,2020-05-02,0,0,0,0,55641,2020-04-26,5,5
American Samoa,2020-05-03,0,0,0,0,55641,2020-04-27,5,5
American Samoa,2020-05-04,0,0,0,0,55641,2020-04-28,5,5
American Samoa,2020-05-05,0,0,0,0,55641,2020-04-29,5,5
American Samoa,2020-05-06,0,0,0,0,55641,2020-04-30,5,5
American Samoa,2020-05-07,0,0,0,0,55641,2020-05-01,5,5
American Samoa,2020-05-08,0,0,0,0,55641,2020-05-02,5,5
American Samoa,2020-05-09,0,0,0,0,55641,2020-05-03,5,5
American Samoa,2020-05-10,0,0,0,0,55641,2020-05-04,5,5
Arizona,2020-03-08,0,0,4,0,7278717,2020-03-02,4.95857142832992,2.47928571416496
Arizona,2020-03-09,0,0,4,0,7278717,2020-03-03,2.85413106516307,1.42706553258154
Arizona,2020-03-10,2,0,6,0,7278717,2020-03-04,3.24596097855396,1.32515802040706
Arizona,2020-03-11,3,0,9,0,7278717,2020-03-05,3.68145934165669,1.22715311388556
Arizona,2020-03-12,0,0,9,0,7278717,2020-03-06,2.5568521773368,0.852284059112265
Arizona,2020-03-13,0,0,9,0,7278717,2020-03-07,1.70828800117633,0.603971014925699
Arizona,2020-03-14,3,0,12,0,7278717,2020-03-08,1.65839855677236,0.552799518924118
Arizona,2020-03-15,0,0,12,0,7278717,2020-03-09,1.50056450098739,0.500188166995798
Arizona,2020-03-16,6,0,18,0,7278717,2020-03-10,2.29180699834958,0.591742022488635
Arizona,2020-03-17,2,0,20,0,7278717,2020-03-11,1.93864357730438,0.500555619275456
Arizona,2020-03-18,7,0,27,0,7278717,2020-03-12,2.0335037352642,0.466517751754166
Arizona,2020-03-19,18,0,45,0,7278717,2020-03-13,3.34202951916571,0.549426268495452
Arizona,2020-03-20,23,0,68,0,7278717,2020-03-14,3.95103981984365,0.510077047415227
Arizona,2020-03-21,36,1,104,1,7278717,2020-03-15,3.97397093049059,0.412081589118166
Arizona,2020-03-22,48,1,152,2,7278717,2020-03-16,3.85304251783181,0.324484715834303
Arizona,2020-03-23,83,0,235,2,7278717,2020-03-17,3.84738364121306,0.260577700492419
Arizona,2020-03-24,91,3,326,5,7278717,2020-03-18,3.51073275147805,0.200368101418678
Arizona,2020-03-25,75,1,401,6,7278717,2020-03-19,2.85653147480267,0.147510651064374
Arizona,2020-03-26,107,2,508,8,7278717,2020-03-20,2.5272089807861,0.117322731582789
Arizona,2020-03-27,157,5,665,13,7278717,2020-03-21,2.46542100324494,0.100818562181458
Arizona,2020-03-28,108,2,773,15,7278717,2020-03-22,2.1281117913383,0.0822161312242448
Arizona,2020-03-29,146,2,919,17,7278717,2020-03-23,1.94736064715839,0.0702693246153864
Arizona,2020-03-30,238,3,1157,20,7278717,2020-03-24,1.94137719683207,0.0639012087975259
Arizona,2020-03-31,132,5,1289,25,7278717,2020-03-25,1.69681811886895,0.0546508317533212
Arizona,2020-04-01,124,7,1413,32,7278717,2020-03-26,1.53147102050338,0.0481176114097584
Arizona,2020-04-02,183,3,1596,35,7278717,2020-03-27,1.46602645193704,0.0444250439980923
Arizona,2020-04-03,173,9,1769,44,7278717,2020-03-28,1.34811468788615,0.0405551209915275
Arizona,2020-04-04,250,8,2019,52,7278717,2020-03-29,1.4035152147755,0.0397451278389402
Arizona,2020-04-05,250,12,2269,64,7278717,2020-03-30,1.40644471723928,0.0382644073837299
Arizona,2020-04-06,191,1,2460,65,7278717,2020-03-31,1.24772824770985,0.0345526381151363
Arizona,2020-04-07,115,8,2575,73,7278717,2020-04-01,1.15446117677718,0.0321802978314435
Arizona,2020-04-08,151,16,2726,89,7278717,2020-04-02,1.13333200132551,0.0312650746012832
Arizona,2020-04-09,292,9,3018,98,7278717,2020-04-03,1.1913561144385,0.0315819650115627
Arizona,2020-04-10,94,8,3112,106,7278717,2020-04-04,1.08549833894431,0.0296093946723878
Arizona,2020-04-11,281,11,3393,117,7278717,2020-04-05,1.07961652039485,0.0291150923825299
Arizona,2020-04-12,149,8,3542,125,7278717,2020-04-06,0.983834878725163,0.0275636991471033
Arizona,2020-04-13,163,7,3705,132,7278717,2020-04-07,0.957367757156034,0.027121879105206
Arizona,2020-04-14,104,11,3809,143,7278717,2020-04-08,0.956762888194752,0.0272251851761548
Arizona,2020-04-15,155,12,3964,155,7278717,2020-04-09,0.96945041292192,0.0275416494804743
Arizona,2020-04-16,273,9,4237,164,7278717,2020-04-10,0.962396917800395,0.0275533436040653
Arizona,2020-04-17,274,19,4511,183,7278717,2020-04-11,1.1129912998613,0.0297459437038654
Arizona,2020-04-18,213,-3,4724,180,7278717,2020-04-12,1.04742390666399,0.0286992382558301
Arizona,2020-04-19,209,4,4933,184,7278717,2020-04-13,1.07529489458051,0.0288209283781712
Arizona,2020-04-20,135,7,5068,191,7278717,2020-04-14,1.04006815996211,0.0281614243102865
Arizona,2020-04-21,188,17,5256,208,7278717,2020-04-15,1.09066795130256,0.028662117422429
Arizona,2020-04-22,217,23,5473,231,7278717,2020-04-16,1.1206753032078,0.0288397391306815
Arizona,2020-04-23,299,18,5772,249,7278717,2020-04-17,1.1128220875126,0.0283942321760903
Arizona,2020-04-24,273,17,6045,266,7278717,2020-04-18,1.0842693569255,0.0276747046200956
Arizona,2020-04-25,241,7,6286,273,7278717,2020-04-19,1.08146017179758,0.0273546423404076
Arizona,2020-04-26,248,2,6534,275,7278717,2020-04-20,1.08904429314024,0.0272091069476236
Arizona,2020-04-27,191,0,6725,275,7278717,2020-04-21,1.10625310548831,0.0271682859599927
Arizona,2020-04-28,230,0,6955,275,7278717,2020-04-22,1.11002079058006,0.026921958624666
Arizona,2020-04-29,254,33,7209,308,7278717,2020-04-23,1.10763325384731,0.0265763954057439
Arizona,2020-04-30,446,12,7655,320,7278717,2020-04-24,1.17340828818099,0.0270338999534692
Arizona,2020-05-01,314,10,7969,330,7278717,2020-04-25,1.16161432013935,0.0264756475093701
Arizona,2020-05-02,395,0,8364,330,7278717,2020-04-26,1.20964539908965,0.0265296080210441
Arizona,2020-05-03,276,32,8640,362,7278717,2020-04-27,1.17722204883011,0.0256463827729445
Arizona,2020-05-04,284,0,8924,362,7278717,2020-04-28,1.17954635596519,0.0251480128066429
Arizona,2020-05-05,381,33,9305,395,7278717,2020-04-29,1.2136432412638,0.025030223475325
Arizona,2020-05-06,402,31,9707,426,7278717,2020-04-30,1.23595055277354,0.0247239563413171
Arizona,2020-05-07,238,24,9945,450,7278717,2020-05-01,1.07924796655365,0.0225480346982108
Arizona,2020-05-08,581,67,10526,517,7278717,2020-05-02,1.16856972372539,0.0231049141935979
Arizona,2020-05-09,434,15,10960,532,7278717,2020-05-03,1.15478340032273,0.0226602427295592
Arizona,2020-05-10,159,4,11119,536,7278717,2020-05-04,1.06410313743205,0.0213677051982803
Arkansas,2020-03-08,0,0,0,0,3017804,2020-03-02,5,5
Arkansas,2020-03-09,0,0,0,0,3017804,2020-03-03,5,5
Arkansas,2020-03-10,0,0,0,0,3017804,2020-03-04,5,5
Arkansas,2020-03-11,0,0,0,0,3017804,2020-03-05,5,5
Arkansas,2020-03-12,0,0,0,0,3017804,2020-03-06,5,5
Arkansas,2020-03-13,9,0,9,0,3017804,2020-03-07,50,15.8113883008419
Arkansas,2020-03-14,3,0,12,0,3017804,2020-03-08,9.47843295390781,2.62884430972017
Arkansas,2020-03-15,-9,0,3,0,3017804,2020-03-09,3.50631354630241,0.972476406080562
Arkansas,2020-03-16,0,0,3,0,3017804,2020-03-10,2.23438625945377,0.61970724828098
Arkansas,2020-03-17,0,0,3,0,3017804,2020-03-11,1.75576344179713,0.486961162844975
Arkansas,2020-03-18,1,0,4,0,3017804,2020-03-12,1.62865406223487,0.435276107318606
Arkansas,2020-03-19,58,0,62,0,3017804,2020-03-13,7.48293910054324,0.881872830200015
Arkansas,2020-03-20,38,0,100,0,3017804,2020-03-14,5.59215359245244,0.556440079785657
Arkansas,2020-03-21,22,0,122,0,3017804,2020-03-15,3.42444168053294,0.312607325881466
Arkansas,2020-03-22,43,0,165,0,3017804,2020-03-16,3.03489349151083,0.237711204182629
Arkansas,2020-03-23,27,0,192,0,3017804,2020-03-17,2.51382397494392,0.182371959077896
Arkansas,2020-03-24,27,2,219,2,3017804,2020-03-18,2.1565605142337,0.146396866885462
Arkansas,2020-03-25,61,0,280,2,3017804,2020-03-19,2.19577875104504,0.131931558719164
Arkansas,2020-03-26,55,0,335,2,3017804,2020-03-20,1.7525842245037,0.105877485044462
Arkansas,2020-03-27,46,1,381,3,3017804,2020-03-21,1.51826896473322,0.090411601144611
Arkansas,2020-03-28,28,2,409,5,3017804,2020-03-22,1.38119203422883,0.081387521127004
Arkansas,2020-03-29,17,1,426,6,3017804,2020-03-23,1.1523559724293,0.07119278973252
Arkansas,2020-03-30,47,1,473,7,3017804,2020-03-24,1.18067021387429,0.0703078880881173
Arkansas,2020-03-31,50,1,523,8,3017804,2020-03-25,1.2347881574843,0.0707037642206002
Arkansas,2020-04-01,61,2,584,10,3017804,2020-03-26,1.17989372897061,0.0675605183875948
Arkansas,2020-04-02,59,2,643,12,3017804,2020-03-27,1.14505566235405,0.0651399407173791
Arkansas,2020-04-03,61,0,704,12,3017804,2020-03-28,1.16165733330023,0.0645365185166795
Arkansas,2020-04-04,39,2,743,14,3017804,2020-03-29,1.16261644298019,0.0635205218569469
Arkansas,2020-04-05,94,2,837,16,3017804,2020-03-30,1.38121791343496,0.0680477224816229
Arkansas,2020-04-06,38,0,875,16,3017804,2020-03-31,1.27034890372829,0.0632805862687782
Arkansas,2020-04-07,71,2,946,18,3017804,2020-04-01,1.24920299439294,0.0606666603834112
Arkansas,2020-04-08,54,0,1000,18,3017804,2020-04-02,1.16560821359002,0.0570800797985127
Arkansas,2020-04-09,119,3,1119,21,3017804,2020-04-03,1.27845370883329,0.0585363741425447
Arkansas,2020-04-10,52,0,1171,21,3017804,2020-04-04,1.19501524171278,0.0552395990891849
Arkansas,2020-04-11,57,4,1228,25,3017804,2020-04-05,1.18112064974052,0.0535767206764593
Arkansas,2020-04-12,52,2,1280,27,3017804,2020-04-06,1.03819343658582,0.0492704800736599
Arkansas,2020-04-13,130,2,1410,29,3017804,2020-04-07,1.22795714252072,0.0530396701695378
Arkansas,2020-04-14,88,3,1498,32,3017804,2020-04-08,1.22851002880388,0.052241560413982
Arkansas,2020-04-15,71,1,1569,33,3017804,2020-04-09,1.20382354589698,0.0504226197092518
Arkansas,2020-04-16,51,4,1620,37,3017804,2020-04-10,1.01359854861707,0.045239117195396
Arkansas,2020-04-17,75,0,1695,37,3017804,2020-04-11,1.04004053911734,0.0453910904412179
Arkansas,2020-04-18,49,1,1744,38,3017804,2020-04-12,1.01994468404958,0.0448571159149035
Arkansas,2020-04-19,37,1,1781,39,3017804,2020-04-13,0.984022879165653,0.0439190904665986
Arkansas,2020-04-20,192,2,1973,41,3017804,2020-04-14,1.10652986688929,0.0465933126559149
Arkansas,2020-04-21,17,1,1990,42,3017804,2020-04-15,0.956057609669109,0.0430586691840215
Arkansas,2020-04-22,286,0,2276,42,3017804,2020-04-16,1.3661831218956,0.0513443058548668
Arkansas,2020-04-23,323,3,2599,45,3017804,2020-04-17,1.81565800791133,0.0579990675654512
Arkansas,2020-04-24,211,2,2810,47,3017804,2020-04-18,1.80942380957583,0.0541636849688842
Arkansas,2020-04-25,101,1,2911,48,3017804,2020-04-19,1.61204401667196,0.0471688702604861
Arkansas,2020-04-26,90,3,3001,51,3017804,2020-04-20,1.47392344005619,0.0421810215712236
Arkansas,2020-04-27,68,0,3069,51,3017804,2020-04-21,1.19304039607018,0.0360206740324668
Arkansas,2020-04-28,58,6,3127,57,3017804,2020-04-22,1.16349303168731,0.0344899572095584
Arkansas,2020-04-29,66,0,3193,57,3017804,2020-04-23,0.906416515770103,0.0299162028667749
Arkansas,2020-04-30,88,4,3281,61,3017804,2020-04-24,0.672864474623387,0.0257464435904303
Arkansas,2020-05-01,56,3,3337,64,3017804,2020-04-25,0.549912967006245,0.0239318900690225
Arkansas,2020-05-02,35,8,3372,72,3017804,2020-04-26,0.530486839176202,0.0246804813838825
Arkansas,2020-05-03,65,4,3437,76,3017804,2020-04-27,0.562499129615349,0.0269079824833211
Arkansas,2020-05-04,54,4,3491,80,3017804,2020-04-28,0.608475789927171,0.0295851053081338
Arkansas,2020-05-05,34,3,3525,83,3017804,2020-04-29,0.634345310005311,0.0317569865746909
Arkansas,2020-05-06,86,4,3611,87,3017804,2020-04-30,0.729358263733775,0.0356314828503049
Arkansas,2020-05-07,92,0,3703,87,3017804,2020-05-01,0.793216160722187,0.0385674895132448
Arkansas,2020-05-08,44,1,3747,88,3017804,2020-05-02,0.813547715886982,0.0401293494364416
Arkansas,2020-05-09,0,0,3747,88,3017804,2020-05-03,0.778457285321057,0.0401458691692541
Arkansas,2020-05-10,265,3,4012,91,3017804,2020-05-04,1.25120414310275,0.0521335059626147
California,2020-03-08,14,0,95,1,39512223,2020-03-02,2.77244539507198,0.30249859245355
California,2020-03-09,6,0,101,1,39512223,2020-03-03,1.93833048311768,0.215370053679742
California,2020-03-10,43,1,144,2,39512223,2020-03-04,2.32154495751454,0.211927090248848
California,2020-03-11,34,2,178,4,39512223,2020-03-05,2.25522155639844,0.18793512969987
California,2020-03-12,43,0,221,4,39512223,2020-03-06,2.11814041261831,0.161978245733908
California,2020-03-13,60,0,281,4,39512223,2020-03-07,2.23512484310807,0.149675030108639
California,2020-03-14,91,-1,372,3,39512223,2020-03-08,2.35402509696382,0.137758898938564
California,2020-03-15,1,2,373,5,39512223,2020-03-09,1.77234115668473,0.106107289580282
California,2020-03-16,184,2,557,7,39512223,2020-03-10,2.41831792202729,0.11312414098467
California,2020-03-17,143,5,700,12,39512223,2020-03-11,2.3770984025942,0.100720891840622
California,2020-03-18,128,4,828,16,39512223,2020-03-12,2.15221741770742,0.084352051131444
California,2020-03-19,177,2,1005,18,39512223,2020-03-13,2.07798253205247,0.074166376947011
California,2020-03-20,238,6,1243,24,39512223,2020-03-14,2.08028164883835,0.0670361392474703
California,2020-03-21,162,1,1405,25,39512223,2020-03-15,1.82706723513949,0.0568190881930979
California,2020-03-22,241,5,1646,30,39512223,2020-03-16,1.89116894283697,0.0529841062803647
California,2020-03-23,462,9,2108,39,39512223,2020-03-17,1.95403769673009,0.0496006170475356
California,2020-03-24,430,11,2538,50,39512223,2020-03-18,1.93687107417873,0.0451658147275745
California,2020-03-25,460,15,2998,65,39512223,2020-03-19,1.91046572113484,0.0410024056524886
California,2020-03-26,901,16,3899,81,39512223,2020-03-20,2.13809524189551,0.039737703319182
California,2020-03-27,758,13,4657,94,39512223,2020-03-21,2.06832512245905,0.035393495246546
California,2020-03-28,438,16,5095,110,39512223,2020-03-22,1.82026832129748,0.0299614886991879
California,2020-03-29,757,14,5852,124,39512223,2020-03-23,1.7469326170539,0.0269333204073355
California,2020-03-30,1286,22,7138,146,39512223,2020-03-24,1.80065070644965,0.0253864700497271
California,2020-03-31,1072,27,8210,173,39512223,2020-03-25,1.74434868848509,0.0231593790695998
California,2020-04-01,1189,26,9399,199,39512223,2020-03-26,1.6947019446414,0.0211804651188528
California,2020-04-02,1374,39,10773,238,39512223,2020-03-27,1.58286605885454,0.0190900829476695
California,2020-04-03,1231,27,12004,265,39512223,2020-03-28,1.4945983589286,0.0174357216530727
California,2020-04-04,833,24,12837,289,39512223,2020-03-29,1.41696232737329,0.0161028843635038
California,2020-04-05,2197,59,15034,348,39512223,2020-03-30,1.5346394281709,0.0160145249276069
California,2020-04-06,985,32,16019,380,39512223,2020-03-31,1.34407546003136,0.0142616005245717
California,2020-04-07,1332,52,17351,432,39512223,2020-04-01,1.26817906804853,0.0132635559027984
California,2020-04-08,1546,63,18897,495,39512223,2020-04-02,1.24036258921585,0.0127265214872656
California,2020-04-09,813,49,19710,544,39512223,2020-04-03,1.10711114439017,0.011710381597047
California,2020-04-10,1371,39,21081,583,39512223,2020-04-04,1.08661734526354,0.0114046390331712
California,2020-04-11,625,21,21706,604,39512223,2020-04-05,1.04139295789688,0.0110573950664116
California,2020-04-12,1089,36,22795,640,39512223,2020-04-06,0.899475226645578,0.0102094509579258
California,2020-04-13,1136,74,23931,714,39512223,2020-04-07,0.926057691385345,0.0104104010424198
California,2020-04-14,1425,53,25356,767,39512223,2020-04-08,0.956542045978078,0.0106904570207268
California,2020-04-15,1330,93,26686,860,39512223,2020-04-09,0.942171893731002,0.0106748410163139
California,2020-04-16,991,96,27677,956,39512223,2020-04-10,0.974718325322619,0.0109195431408363
California,2020-04-17,1480,81,29157,1037,39512223,2020-04-11,0.996909198529548,0.0110925287199359
California,2020-04-18,1334,103,30491,1140,39512223,2020-04-12,1.08701042898964,0.0115967985052608
California,2020-04-19,940,37,31431,1177,39512223,2020-04-13,1.05672188867971,0.0113704916496029
California,2020-04-20,2255,48,33686,1225,39512223,2020-04-14,1.17456649121432,0.0118916388460467
California,2020-04-21,1779,57,35465,1282,39512223,2020-04-15,1.18470701871357,0.0117824439812392
California,2020-04-22,1879,139,37344,1421,39512223,2020-04-16,1.19987943305449,0.0116219600468441
California,2020-04-23,2217,112,39561,1533,39512223,2020-04-17,1.28354702369096,0.011773679000582
California,2020-04-24,1794,88,41355,1621,39512223,2020-04-18,1.24904066472496,0.0113087463245396
California,2020-04-25,1013,68,42368,1689,39512223,2020-04-19,1.14943005999974,0.0105465615167929
California,2020-04-26,1190,36,43558,1725,39512223,2020-04-20,1.12762235698886,0.0102392720903585
California,2020-04-27,1408,54,44966,1779,39512223,2020-04-21,1.01936294916589,0.00959743201945085
California,2020-04-28,1198,85,46164,1864,39512223,2020-04-22,0.953652852149575,0.00921931010055464
California,2020-04-29,2583,82,48747,1946,39512223,2020-04-23,1.0219238867055,0.00956951541293756
California,2020-04-30,1383,85,50130,2031,39512223,2020-04-24,0.94912035385733,0.00923174486001855
California,2020-05-01,1896,95,52026,2126,39512223,2020-04-25,0.961934130881272,0.00931155957364928
California,2020-05-02,1321,54,53347,2180,39512223,2020-04-26,1.00026517126118,0.00954583618227212
California,2020-05-03,1556,36,54903,2216,39512223,2020-04-27,1.03700143753392,0.00973549344756974
California,2020-05-04,981,62,55884,2278,39512223,2020-04-28,0.992793658638236,0.00950096157126581
California,2020-05-05,2572,103,58456,2381,39512223,2020-04-29,1.11461729956388,0.0100530267574019
California,2020-05-06,2160,83,60616,2464,39512223,2020-04-30,1.06169446666093,0.00974482836742478
California,2020-05-07,1532,71,62148,2535,39512223,2020-05-01,1.05415714351029,0.00961548486288287
California,2020-05-08,1631,78,63779,2613,39512223,2020-05-02,1.01879589497173,0.00939711070513147
California,2020-05-09,2779,74,66558,2687,39512223,2020-05-03,1.13678936163982,0.00988998694210037
California,2020-05-10,1042,29,67600,2716,39512223,2020-05-04,1.07205427956211,0.00951369257331468
Colorado,2020-03-08,0,0,7,0,5758736,2020-03-02,4.54620155134661,1.60732497279899
Colorado,2020-03-09,0,0,7,0,5758736,2020-03-03,2.57090375519484,0.908951739538114
Colorado,2020-03-10,7,0,14,0,5758736,2020-03-04,3.63392331047971,0.93827496419219
Colorado,2020-03-11,16,0,30,0,5758736,2020-03-05,5.34254072625834,0.959548640729975
Colorado,2020-03-12,15,0,45,0,5758736,2020-03-06,4.6128306698667,0.68012477737645
Colorado,2020-03-13,31,1,76,1,5758736,2020-03-07,4.36531450820154,0.507457503952565
Colorado,2020-03-14,25,-1,101,0,5758736,2020-03-08,3.43992210281404,0.352928561034645
Colorado,2020-03-15,-2,1,99,1,5758736,2020-03-09,2.27932970670969,0.233854293634874
Colorado,2020-03-16,33,0,132,1,5758736,2020-03-10,2.33868547806942,0.206712545075674
Colorado,2020-03-17,35,1,167,2,5758736,2020-03-11,2.2662553189135,0.181445640134289
Colorado,2020-03-18,51,0,218,2,5758736,2020-03-12,2.19576648836639,0.158880087013404
Colorado,2020-03-19,59,2,277,4,5758736,2020-03-13,2.16601094381938,0.141294974519436
Colorado,2020-03-20,86,0,363,4,5758736,2020-03-14,2.15569179224442,0.126586580744781
Colorado,2020-03-21,112,2,475,6,5758736,2020-03-15,2.2648380432528,0.116645093697623
Colorado,2020-03-22,116,0,591,6,5758736,2020-03-16,2.36692784237116,0.106601068718425
Colorado,2020-03-23,113,1,704,7,5758736,2020-03-17,2.16131089713236,0.0902900580325249
Colorado,2020-03-24,19,1,723,8,5758736,2020-03-18,1.67788351816061,0.0710942063523268
Colorado,2020-03-25,298,8,1021,16,5758736,2020-03-19,2.06372521566118,0.0727819766601727
Colorado,2020-03-26,409,3,1430,19,5758736,2020-03-20,2.4916546524593,0.0733474371738176
Colorado,2020-03-27,3,8,1433,27,5758736,2020-03-21,1.80541059075901,0.05516723916892
Colorado,2020-03-28,307,4,1740,31,5758736,2020-03-22,1.75448022317131,0.0493096164343854
Colorado,2020-03-29,567,16,2307,47,5758736,2020-03-23,2.05973059409194,0.0497078835477995
Colorado,2020-03-30,4,0,2311,47,5758736,2020-03-24,1.60868781603771,0.0401170278845053
Colorado,2020-03-31,655,22,2966,69,5758736,2020-03-25,1.92869323519639,0.0407147461072262
Colorado,2020-04-01,16,0,2982,69,5758736,2020-03-26,1.44632187944893,0.0326524260523052
Colorado,2020-04-02,360,11,3342,80,5758736,2020-03-27,1.24205419568353,0.0283976930898521
Colorado,2020-04-03,400,17,3742,97,5758736,2020-03-28,1.40987551934733,0.0293342358680632
Colorado,2020-04-04,446,14,4188,111,5758736,2020-03-29,1.39293734859939,0.0281473290809414
Colorado,2020-04-05,762,29,4950,140,5758736,2020-03-30,1.38198070921076,0.0268764098643715
Colorado,2020-04-06,233,10,5183,150,5758736,2020-03-31,1.38689096972927,0.0258746514000411
Colorado,2020-04-07,246,29,5429,179,5758736,2020-04-01,1.09832335236507,0.0221263544815278
Colorado,2020-04-08,226,14,5655,193,5758736,2020-04-02,1.13959581222847,0.0220378967069742
Colorado,2020-04-09,0,0,5655,193,5758736,2020-04-03,0.963043995196182,0.0200200173884318
Colorado,2020-04-10,547,33,6202,226,5758736,2020-04-04,1.01562540179164,0.0204728237499768
Colorado,2020-04-11,311,24,6513,250,5758736,2020-04-05,0.963166698222441,0.0199708524553216
Colorado,2020-04-12,794,39,7307,289,5758736,2020-04-06,0.978982562279749,0.0201605815609382
Colorado,2020-04-13,384,17,7691,306,5758736,2020-04-07,1.04888848254304,0.0209401113125542
Colorado,2020-04-14,259,21,7950,327,5758736,2020-04-08,1.04949992159247,0.0208982475524225
Colorado,2020-04-15,6,1,7956,328,5758736,2020-04-09,0.946984571808345,0.0197374136916863
Colorado,2020-04-16,330,27,8286,355,5758736,2020-04-10,1.08550209298176,0.0211586386989122
Colorado,2020-04-17,405,17,8691,372,5758736,2020-04-11,1.0217681749911,0.0204763572491456
Colorado,2020-04-18,356,17,9047,389,5758736,2020-04-12,1.02767097298835,0.0204110387885366
Colorado,2020-04-19,683,31,9730,420,5758736,2020-04-13,0.978136542989455,0.0198670404774194
Colorado,2020-04-20,0,0,9730,420,5758736,2020-04-14,0.823359340906237,0.0182294822113761
Colorado,2020-04-21,743,63,10473,483,5758736,2020-04-15,1.04550868144957,0.0208105217180746
Colorado,2020-04-22,418,23,10891,506,5758736,2020-04-16,1.23156515602059,0.0227289497001079
Colorado,2020-04-23,387,46,11278,552,5758736,2020-04-17,1.21066585095304,0.0221294659938587
Colorado,2020-04-24,978,122,12256,674,5758736,2020-04-18,1.37435022610768,0.0230147758141896
Colorado,2020-04-25,712,10,12968,684,5758736,2020-04-19,1.41687630013482,0.0226244557826351
Colorado,2020-04-26,473,4,13441,688,5758736,2020-04-20,1.23219555666208,0.0202244003913622
Colorado,2020-04-27,438,18,13879,706,5758736,2020-04-21,1.29243089070631,0.0200624183052162
Colorado,2020-04-28,437,30,14316,736,5758736,2020-04-22,1.13314503962345,0.0182765328971524
Colorado,2020-04-29,442,30,14758,766,5758736,2020-04-23,1.09247145795302,0.0175657568426327
Colorado,2020-04-30,526,11,15284,777,5758736,2020-04-24,1.1072351871562,0.017491627001017
Colorado,2020-05-01,509,44,15793,821,5758736,2020-04-25,0.956547147457092,0.0160815337545728
Colorado,2020-05-02,432,11,16225,832,5758736,2020-04-26,0.877201075381523,0.0153682216453621
Colorado,2020-05-03,410,10,16635,842,5758736,2020-04-27,0.879274420664576,0.0155556802605277
Colorado,2020-05-04,283,9,16918,851,5758736,2020-04-28,0.8607231522095,0.0156108551211954
Colorado,2020-05-05,449,52,17367,903,5758736,2020-04-29,0.890364963110174,0.0161166879430503
Colorado,2020-05-06,465,16,17832,919,5758736,2020-04-30,0.922649834699548,0.0166385067875902
Colorado,2020-05-07,538,25,18370,944,5758736,2020-05-01,0.945249644520046,0.0170128944644371
Colorado,2020-05-08,457,16,18827,960,5758736,2020-05-02,0.942620340712302,0.0171102935070113
Colorado,2020-05-09,548,7,19375,967,5758736,2020-05-03,0.990946112296437,0.0176532973543723
Colorado,2020-05-10,328,4,19703,971,5758736,2020-05-04,0.971600103095883,0.0175383651549645
Connecticut,2020-03-08,0,0,0,0,3565287,2020-03-02,5,5
Connecticut,2020-03-09,0,0,0,0,3565287,2020-03-03,5,5
Connecticut,2020-03-10,1,0,1,0,3565287,2020-03-04,10,7.07106781186548
Connecticut,2020-03-11,2,0,3,0,3565287,2020-03-05,12.1149517836282,6.05747589181412
Connecticut,2020-03-12,2,0,5,0,3565287,2020-03-06,7.43785714249488,3.03649246313797
Connecticut,2020-03-13,6,0,11,0,3565287,2020-03-07,7.22100567343614,2.08452478468909
Connecticut,2020-03-14,12,0,23,0,3565287,2020-03-08,7.22421554111171,1.47463682230066
Connecticut,2020-03-15,1,0,24,0,3565287,2020-03-09,3.65388717922693,0.730777435845387
Connecticut,2020-03-16,17,0,41,0,3565287,2020-03-10,3.80520043283963,0.587155174064357
Connecticut,2020-03-17,27,0,68,0,3565287,2020-03-11,4.11582441712189,0.499117023773229
Connecticut,2020-03-18,28,1,96,1,3565287,2020-03-12,3.60994531859562,0.372337429943199
Connecticut,2020-03-19,63,2,159,3,3565287,2020-03-13,3.90890892919685,0.313971120685048
Connecticut,2020-03-20,35,1,194,4,3565287,2020-03-14,3.02129417791579,0.222732761855653
Connecticut,2020-03-21,0,0,194,4,3565287,2020-03-15,1.95759516780218,0.149265232189924
Connecticut,2020-03-22,133,4,327,8,3565287,2020-03-16,2.76377977165491,0.158513641142706
Connecticut,2020-03-23,88,2,415,10,3565287,2020-03-17,2.63365242021229,0.136001226175747
Connecticut,2020-03-24,203,2,618,12,3565287,2020-03-18,2.87585195584375,0.122515412356349
Connecticut,2020-03-25,257,7,875,19,3565287,2020-03-19,3.00130671697226,0.107464019078915
Connecticut,2020-03-26,137,2,1012,21,3565287,2020-03-20,2.36012479226276,0.0807618077811609
Connecticut,2020-03-27,279,6,1291,27,3565287,2020-03-21,2.31060597074199,0.0697308117904747
Connecticut,2020-03-28,233,6,1524,33,3565287,2020-03-22,2.21499900159657,0.0607133933827078
Connecticut,2020-03-29,469,1,1993,34,3565287,2020-03-23,2.20919364668937,0.0541085611882706
Connecticut,2020-03-30,578,2,2571,36,3565287,2020-03-24,2.2913476743026,0.0493362252995837
Connecticut,2020-03-31,557,33,3128,69,3565287,2020-03-25,2.11847190670051,0.042276531848687
Connecticut,2020-04-01,429,16,3557,85,3565287,2020-03-26,1.8218705211548,0.0351728186179534
Connecticut,2020-04-02,267,27,3824,112,3565287,2020-03-27,1.60476622301906,0.0302570726957079
Connecticut,2020-04-03,1090,19,4914,131,3565287,2020-03-28,1.81129649606735,0.0300881477102541
Connecticut,2020-04-04,362,34,5276,165,3565287,2020-03-29,1.62608165053442,0.0265431870072165
Connecticut,2020-04-05,399,24,5675,189,3565287,2020-03-30,1.38894613686107,0.0228867720842856
Connecticut,2020-04-06,1231,17,6906,206,3565287,2020-03-31,1.48694282287828,0.0225813359652066
Connecticut,2020-04-07,875,71,7781,277,3565287,2020-04-01,1.45826802057989,0.0213758878606708
Connecticut,2020-04-08,0,49,7781,326,3565287,2020-04-02,1.20127463147045,0.0184811481764685
Connecticut,2020-04-09,2003,54,9784,380,3565287,2020-04-03,1.59231687001635,0.0206238592158366
Connecticut,2020-04-10,754,68,10538,448,3565287,2020-04-04,1.37563616079369,0.0183418154772493
Connecticut,2020-04-11,972,46,11510,494,3565287,2020-04-05,1.38238793331302,0.0175069989357193
Connecticut,2020-04-12,525,60,12035,554,3565287,2020-04-06,1.30708827720185,0.0163886138268596
Connecticut,2020-04-13,1346,48,13381,602,3565287,2020-04-07,1.23993900469578,0.0154080224213254
Connecticut,2020-04-14,608,69,13989,671,3565287,2020-04-08,1.12472357338166,0.0142736475174186
Connecticut,2020-04-15,766,197,14755,868,3565287,2020-04-09,1.21876963541322,0.0145931658979636
Connecticut,2020-04-16,1129,103,15884,971,3565287,2020-04-10,1.02653712769706,0.013142383896125
Connecticut,2020-04-17,925,65,16809,1036,3565287,2020-04-11,1.03060940143008,0.0130134088661753
Connecticut,2020-04-18,741,50,17550,1086,3565287,2020-04-12,0.988451821488346,0.0127174807282771
Connecticut,2020-04-19,412,41,17962,1127,3565287,2020-04-13,0.968441043295458,0.0125782171879829
Connecticut,2020-04-20,1853,204,19815,1331,3565287,2020-04-14,1.05728499017594,0.0131800722552815
Connecticut,2020-04-21,545,92,20360,1423,3565287,2020-04-15,1.04240462629628,0.0130586549487895
Connecticut,2020-04-22,2109,121,22469,1544,3565287,2020-04-16,1.24748027474953,0.0142025302205216
Connecticut,2020-04-23,631,95,23100,1639,3565287,2020-04-17,1.12665404723098,0.0132620978683624
Connecticut,2020-04-24,836,128,23936,1767,3565287,2020-04-18,1.06929701453599,0.012665271638666
Connecticut,2020-04-25,647,98,24583,1865,3565287,2020-04-19,1.03575238305172,0.0123496531200735
Connecticut,2020-04-26,686,59,25269,1924,3565287,2020-04-20,1.06492323892117,0.0124571597840072
Connecticut,2020-04-27,728,88,25997,2012,3565287,2020-04-21,0.890849749120448,0.0113293459571553
Connecticut,2020-04-28,315,75,26312,2087,3565287,2020-04-22,0.864603149125166,0.011205954938507
Connecticut,2020-04-29,455,82,26767,2169,3565287,2020-04-23,0.643507076685855,0.00981453221038429
Connecticut,2020-04-30,933,88,27700,2257,3565287,2020-04-24,0.732146852439159,0.0107937432424226
Connecticut,2020-05-01,1064,82,28764,2339,3565287,2020-04-25,0.828303409644566,0.0119195770794484
Connecticut,2020-05-02,523,97,29287,2436,3565287,2020-04-26,0.847131463403223,0.0123501149068358
Connecticut,2020-05-03,0,0,29287,2436,3565287,2020-04-27,0.750162016082581,0.0118330327658295
Connecticut,2020-05-04,686,120,29973,2556,3565287,2020-04-28,0.778910443173658,0.0123512164083197
Connecticut,2020-05-05,648,77,30621,2633,3565287,2020-04-29,0.89232527738735,0.013592037390788
Connecticut,2020-05-06,374,85,30995,2718,3565287,2020-04-30,0.907273956211633,0.013951458186627
Connecticut,2020-05-07,789,79,31784,2797,3565287,2020-05-01,0.895207411238658,0.0140064359147739
Connecticut,2020-05-08,627,77,32411,2874,3565287,2020-05-02,0.817718753561677,0.0135386868508917
Connecticut,2020-05-09,573,58,32984,2932,3565287,2020-05-03,0.857882013886431,0.0141073067320248
Connecticut,2020-05-10,570,35,33554,2967,3565287,2020-05-04,1.02787629336821,0.0157336195480728
Delaware,2020-03-08,0,0,0,0,973764,2020-03-02,5,5
Delaware,2020-03-09,0,0,0,0,973764,2020-03-03,5,5
Delaware,2020-03-10,0,0,0,0,973764,2020-03-04,5,5
Delaware,2020-03-11,1,0,1,0,973764,2020-03-05,10,7.07106781186548
Delaware,2020-03-12,0,0,1,0,973764,2020-03-06,6.05747589181412,4.2832822799758
Delaware,2020-03-13,3,0,4,0,973764,2020-03-07,9.15176162888786,4.09279222321349
Delaware,2020-03-14,2,0,6,0,973764,2020-03-08,6.36767051369044,2.4067532300034
Delaware,2020-03-15,0,0,6,0,973764,2020-03-09,3.28601819814377,1.24199813656014
Delaware,2020-03-16,2,0,8,0,973764,2020-03-10,2.86472202221646,0.95490734073882
Delaware,2020-03-17,8,0,16,0,973764,2020-03-11,4.08450352017891,0.990637614229695
Delaware,2020-03-18,3,0,19,0,973764,2020-03-12,3.06108306527012,0.702260617857692
Delaware,2020-03-19,11,0,30,0,973764,2020-03-13,3.35165816767541,0.611926261160751
Delaware,2020-03-20,9,0,39,0,973764,2020-03-14,2.83882408574057,0.473137347623428
Delaware,2020-03-21,6,0,45,0,973764,2020-03-15,2.27691880599601,0.360012473710923
Delaware,2020-03-22,11,0,56,0,973764,2020-03-16,2.26965915968009,0.317815851883177
Delaware,2020-03-23,12,0,68,0,973764,2020-03-17,2.17391987144882,0.278341917564429
Delaware,2020-03-24,36,0,104,0,973764,2020-03-18,2.55278149963517,0.270594297773274
Delaware,2020-03-25,15,0,119,0,973764,2020-03-19,2.25419787058264,0.224301071532189
Delaware,2020-03-26,11,1,130,1,973764,2020-03-20,1.76722000749092,0.175844963073664
Delaware,2020-03-27,33,1,163,2,973764,2020-03-21,1.8422900021793,0.164779427165646
Delaware,2020-03-28,51,3,214,5,973764,2020-03-22,2.1515159153559,0.165013738002588
Delaware,2020-03-29,18,1,232,6,973764,2020-03-23,1.84180338420522,0.138438419810002
Delaware,2020-03-30,32,0,264,6,973764,2020-03-24,1.71037673237041,0.121859296549352
Delaware,2020-03-31,55,4,319,10,973764,2020-03-25,1.62469851818012,0.110546732094368
Delaware,2020-04-01,49,1,368,11,973764,2020-03-26,1.65408892339566,0.104613769007721
Delaware,2020-04-02,25,1,393,12,973764,2020-03-27,1.53947873512946,0.0947483664190312
Delaware,2020-04-03,57,2,450,14,973764,2020-03-28,1.49515208961984,0.0881026817896189
Delaware,2020-04-04,143,0,593,14,973764,2020-03-29,1.78163914243075,0.0913961595680753
Delaware,2020-04-05,80,0,673,14,973764,2020-03-30,1.81421494946288,0.0862934051429438
Delaware,2020-04-06,110,1,783,15,973764,2020-03-31,1.82204276059378,0.0799018607349545
Delaware,2020-04-07,145,1,928,16,973764,2020-04-01,1.82487975049512,0.0738872213686877
Delaware,2020-04-08,188,3,1116,19,973764,2020-04-02,1.91098923561328,0.06982602697823
Delaware,2020-04-09,93,4,1209,23,973764,2020-04-03,1.76066031310987,0.0615977071431057
Delaware,2020-04-10,117,9,1326,32,973764,2020-04-04,1.61360170144557,0.0544874578991366
Delaware,2020-04-11,153,1,1479,33,973764,2020-04-05,1.43275765832553,0.0481072939725375
Delaware,2020-04-12,146,2,1625,35,973764,2020-04-06,1.39269199264004,0.0451137188084267
Delaware,2020-04-13,133,6,1758,41,973764,2020-04-07,1.31349159535794,0.0420438414219282
Delaware,2020-04-14,168,2,1926,43,973764,2020-04-08,1.25183544960564,0.0396063208786539
Delaware,2020-04-15,88,3,2014,46,973764,2020-04-09,1.06383816754961,0.0354809893909317
Delaware,2020-04-16,56,9,2070,55,973764,2020-04-10,0.990694468631743,0.0337431875083282
Delaware,2020-04-17,247,6,2317,61,973764,2020-04-11,1.13726944466353,0.0361083409764261
Delaware,2020-04-18,221,6,2538,67,973764,2020-04-12,1.19579839970985,0.0367286558829807
Delaware,2020-04-19,0,0,2538,67,973764,2020-04-13,0.992049909560622,0.0328140944636543
Delaware,2020-04-20,207,5,2745,72,973764,2020-04-14,1.05489637899573,0.0335607246236651
Delaware,2020-04-21,186,10,2931,82,973764,2020-04-15,1.0697509223098,0.0337274633655161
Delaware,2020-04-22,269,7,3200,89,973764,2020-04-16,1.24374159281679,0.0360998002326108
Delaware,2020-04-23,108,3,3308,92,973764,2020-04-17,1.25079560357733,0.0355345395971478
Delaware,2020-04-24,134,8,3442,100,973764,2020-04-18,1.07652608696799,0.0320815514999711
Delaware,2020-04-25,134,12,3576,112,973764,2020-04-19,0.96290678804427,0.029872837367397
Delaware,2020-04-26,458,8,4034,120,973764,2020-04-20,1.38717035387567,0.0358524549251888
Delaware,2020-04-27,128,5,4162,125,973764,2020-04-21,1.25641262454394,0.0333652340863524
Delaware,2020-04-28,413,12,4575,137,973764,2020-04-22,1.35986255298878,0.0335283408950391
Delaware,2020-04-29,80,7,4655,144,973764,2020-04-23,1.1279800666801,0.0295611100006333
Delaware,2020-04-30,79,8,4734,152,973764,2020-04-24,1.05389260114536,0.0278987258332291
Delaware,2020-05-01,184,7,4918,159,973764,2020-04-25,1.07387212969614,0.0279423110971572
Delaware,2020-05-02,120,9,5038,168,973764,2020-04-26,1.04909832389864,0.0274279930099081
Delaware,2020-05-03,170,9,5208,177,973764,2020-04-27,0.831561036680823,0.0242591287090857
Delaware,2020-05-04,80,5,5288,182,973764,2020-04-28,0.812110578531495,0.0241909659188638
Delaware,2020-05-05,83,5,5371,187,973764,2020-04-29,0.599959131728702,0.0212516427808332
Delaware,2020-05-06,407,6,5778,193,973764,2020-04-30,0.909966480749135,0.027142024579939
Delaware,2020-05-07,161,9,5939,202,973764,2020-05-01,1.0319404754091,0.0297153597928446
Delaware,2020-05-08,172,11,6111,213,973764,2020-05-02,1.02222071297845,0.0295830204202977
Delaware,2020-05-09,166,8,6277,221,973764,2020-05-03,1.05467560179993,0.0299507744666958
Delaware,2020-05-10,0,0,6277,221,973764,2020-05-04,0.902154405539308,0.0275796649223304
Diamond Princess,2020-03-08,0,0,0,0,0,2020-03-02,5,5
Diamond Princess,2020-03-09,0,0,0,0,0,2020-03-03,5,5
Diamond Princess,2020-03-10,0,0,0,0,0,2020-03-04,5,5
Diamond Princess,2020-03-11,0,0,0,0,0,2020-03-05,5,5
Diamond Princess,2020-03-12,0,0,0,0,0,2020-03-06,5,5
Diamond Princess,2020-03-13,0,0,0,0,0,2020-03-07,5,5
Diamond Princess,2020-03-14,0,0,0,0,0,2020-03-08,5,5
Diamond Princess,2020-03-15,0,0,0,0,0,2020-03-09,5,5
Diamond Princess,2020-03-16,0,0,0,0,0,2020-03-10,5,5
Diamond Princess,2020-03-17,47,0,47,0,0,2020-03-11,240,34.6410161513775
Diamond Princess,2020-03-18,0,0,47,0,0,2020-03-12,7.59732324100269,1.09657915457838
Diamond Princess,2020-03-19,0,0,47,0,0,2020-03-13,2.91295430576578,0.420448738142738
Diamond Princess,2020-03-20,2,0,49,0,0,2020-03-14,2.07355289893191,0.293244663196755
Diamond Princess,2020-03-21,0,0,49,0,0,2020-03-15,1.66051519858617,0.234832311436722
Diamond Princess,2020-03-22,0,0,49,0,0,2020-03-16,1.43450813567893,0.202870086081168
Diamond Princess,2020-03-23,0,0,49,0,0,2020-03-17,1.30139966066674,0.184045705018265
Diamond Princess,2020-03-24,0,0,49,0,0,2020-03-18,0.0729941131471663,0.0421431708747744
Diamond Princess,2020-03-25,0,0,49,0,0,2020-03-19,0.0810933073556113,0.0468192428312393
Diamond Princess,2020-03-26,0,0,49,0,0,2020-03-20,0.105830491966773,0.0611012630254868
Diamond Princess,2020-03-27,0,0,49,0,0,2020-03-21,0.0457686004085765,0.0457686004085765
Diamond Princess,2020-03-28,0,0,49,0,0,2020-03-22,0.0598606444795221,0.0598606444795221
Diamond Princess,2020-03-29,0,0,49,0,0,2020-03-23,0.0793431441400283,0.0793431441400283
Diamond Princess,2020-03-30,0,0,49,0,0,2020-03-24,0.105031688733529,0.105031688733529
Diamond Princess,2020-03-31,0,0,49,0,0,2020-03-25,0.138802679865266,0.138802679865266
Diamond Princess,2020-04-01,0,0,49,0,0,2020-03-26,0.183026102636097,0.183026102636097
Diamond Princess,2020-04-02,0,0,49,0,0,2020-03-27,0.240641906145776,0.240641906145776
Diamond Princess,2020-04-03,0,0,49,0,0,2020-03-28,0.315208065564413,0.315208065564413
Diamond Princess,2020-04-04,0,0,49,0,0,2020-03-29,0.410884831588281,0.410884831588281
Diamond Princess,2020-04-05,0,0,49,0,0,2020-03-30,0.5323030957708,0.5323030957708
Diamond Princess,2020-04-06,0,0,49,0,0,2020-03-31,0.684251224699085,0.684251224699085
Diamond Princess,2020-04-07,0,0,49,0,0,2020-04-01,0.871116424298057,0.871116424298057
Diamond Princess,2020-04-08,0,0,49,0,0,2020-04-02,1.09605311971199,1.09605311971199
Diamond Princess,2020-04-09,0,0,49,0,0,2020-04-03,1.35994144734158,1.35994144734158
Diamond Princess,2020-04-10,0,0,49,0,0,2020-04-04,1.66034307016667,1.66034307016667
Diamond Princess,2020-04-11,0,0,49,0,0,2020-04-05,1.99080975781984,1.99080975781984
Diamond Princess,2020-04-12,0,0,49,0,0,2020-04-06,2.34094604281148,2.34094604281148
Diamond Princess,2020-04-13,0,0,49,0,0,2020-04-07,2.69746160587525,2.69746160587525
Diamond Princess,2020-04-14,0,0,49,0,0,2020-04-08,3.04607452386634,3.04607452386634
Diamond Princess,2020-04-15,0,0,49,0,0,2020-04-09,3.37372745867234,3.37372745867234
Diamond Princess,2020-04-16,0,0,49,0,0,2020-04-10,3.67041891069667,3.67041891069667
Diamond Princess,2020-04-17,0,0,49,0,0,2020-04-11,3.93014749597851,3.93014749597851
Diamond Princess,2020-04-18,0,0,49,0,0,2020-04-12,4.15087670771122,4.15087670771122
Diamond Princess,2020-04-19,0,0,49,0,0,2020-04-13,4.33378534837012,4.33378534837012
Diamond Princess,2020-04-20,0,0,49,0,0,2020-04-14,4.4822087319539,4.4822087319539
Diamond Princess,2020-04-21,0,0,49,0,0,2020-04-15,4.6006127588307,4.6006127588307
Diamond Princess,2020-04-22,0,0,49,0,0,2020-04-16,4.69379088993796,4.69379088993796
Diamond Princess,2020-04-23,0,0,49,0,0,2020-04-17,4.76633442061772,4.76633442061772
Diamond Princess,2020-04-24,0,0,49,0,0,2020-04-18,4.8223422632529,4.8223422632529
Diamond Princess,2020-04-25,0,0,49,0,0,2020-04-19,4.86530483318711,4.86530483318711
Diamond Princess,2020-04-26,0,0,49,0,0,2020-04-20,4.8980974067158,4.8980974067158
Diamond Princess,2020-04-27,0,0,49,0,0,2020-04-21,4.92303267386972,4.92303267386972
Diamond Princess,2020-04-28,0,0,49,0,0,2020-04-22,4.94193868123273,4.94193868123273
Diamond Princess,2020-04-29,0,0,49,0,0,2020-04-23,4.95624195551518,4.95624195551518
Diamond Princess,2020-04-30,0,0,49,0,0,2020-04-24,4.96704514726209,4.96704514726209
Diamond Princess,2020-05-01,0,0,49,0,0,2020-04-25,4.9751945449971,4.9751945449971
Diamond Princess,2020-05-02,0,0,49,0,0,2020-04-26,4.98133625247154,4.98133625247154
Diamond Princess,2020-05-03,0,0,49,0,0,2020-04-27,4.98596159446505,4.98596159446505
Diamond Princess,2020-05-04,0,0,49,0,0,2020-04-28,4.98944309069796,4.98944309069796
Diamond Princess,2020-05-05,0,0,49,0,0,2020-04-29,4.99206255738252,4.99206255738252
Diamond Princess,2020-05-06,0,0,49,0,0,2020-04-30,4.9940328378947,4.9940328378947
Diamond Princess,2020-05-07,0,0,49,0,0,2020-05-01,4.99551448279346,4.99551448279346
Diamond Princess,2020-05-08,0,0,49,0,0,2020-05-02,4.99662848395431,4.99662848395431
Diamond Princess,2020-05-09,0,0,49,0,0,2020-05-03,4.99746595760566,4.99746595760566
Diamond Princess,2020-05-10,0,0,49,0,0,2020-05-04,4.99809548480599,4.99809548480599
District of Columbia,2020-03-08,0,0,0,0,705749,2020-03-02,5,5
District of Columbia,2020-03-09,0,0,0,0,705749,2020-03-03,5,5
District of Columbia,2020-03-10,0,0,0,0,705749,2020-03-04,5,5
District of Columbia,2020-03-11,0,0,0,0,705749,2020-03-05,5,5
District of Columbia,2020-03-12,0,0,0,0,705749,2020-03-06,5,5
District of Columbia,2020-03-13,0,0,0,0,705749,2020-03-07,5,5
District of Columbia,2020-03-14,0,0,0,0,705749,2020-03-08,5,5
District of Columbia,2020-03-15,0,0,0,0,705749,2020-03-09,5,5
District of Columbia,2020-03-16,22,0,22,0,705749,2020-03-10,115,23.9791576165636
District of Columbia,2020-03-17,0,0,22,0,705749,2020-03-11,7.50713610374265,1.56534608591861
District of Columbia,2020-03-18,9,0,31,0,705749,2020-03-12,4.09231033225135,0.723425096663675
District of Columbia,2020-03-19,9,0,40,0,705749,2020-03-13,3.26304561843588,0.509602109445264
District of Columbia,2020-03-20,31,1,71,1,705749,2020-03-14,3.91992109911737,0.46196713181702
District of Columbia,2020-03-21,27,-1,98,0,705749,2020-03-15,3.55746295009999,0.357538479123408
District of Columbia,2020-03-22,4,2,102,2,705749,2020-03-16,2.44526940583926,0.240939553857283
District of Columbia,2020-03-23,18,0,120,2,705749,2020-03-17,1.74975190564926,0.175856683249938
District of Columbia,2020-03-24,21,0,141,2,705749,2020-03-18,1.78050761835778,0.162537364397393
District of Columbia,2020-03-25,46,0,187,2,705749,2020-03-19,2.01837212382622,0.161083632000077
District of Columbia,2020-03-26,44,1,231,3,705749,2020-03-20,2.06686698993682,0.149163276627397
District of Columbia,2020-03-27,40,0,271,3,705749,2020-03-21,1.77588329260912,0.125261149471838
District of Columbia,2020-03-28,33,1,304,4,705749,2020-03-22,1.54773742694728,0.107575187564705
District of Columbia,2020-03-29,38,1,342,5,705749,2020-03-23,1.59559790242179,0.102781496191626
District of Columbia,2020-03-30,59,4,401,9,705749,2020-03-24,1.66691561164957,0.099263380153903
District of Columbia,2020-03-31,94,0,495,9,705749,2020-03-25,1.84738887470621,0.0980492209590222
District of Columbia,2020-04-01,91,0,586,9,705749,2020-03-26,1.78736400082505,0.0893682000412524
District of Columbia,2020-04-02,67,3,653,12,705749,2020-03-27,1.61413439733002,0.0784819000476673
District of Columbia,2020-04-03,104,3,757,15,705749,2020-03-28,1.62802041436233,0.0737726468841716
District of Columbia,2020-04-04,145,6,902,21,705749,2020-03-29,1.77192022653003,0.072398697739446
District of Columbia,2020-04-05,100,1,1002,22,705749,2020-03-30,1.69727085699152,0.0660161851744059
District of Columbia,2020-04-06,95,2,1097,24,705749,2020-03-31,1.55096117198505,0.058746843463604
District of Columbia,2020-04-07,114,-2,1211,22,705749,2020-04-01,1.41567051989403,0.0528691843776709
District of Columbia,2020-04-08,229,5,1440,27,705749,2020-04-02,1.53713816254904,0.0525690159646421
District of Columbia,2020-04-09,83,5,1523,32,705749,2020-04-03,1.41868563950203,0.0480703290710872
District of Columbia,2020-04-10,137,6,1660,38,705749,2020-04-04,1.33779417896099,0.0444943725344748
District of Columbia,2020-04-11,118,9,1778,47,705749,2020-04-05,1.2040703295356,0.0406585660695549
District of Columbia,2020-04-12,97,3,1875,50,705749,2020-04-06,1.13757767104226,0.0384791387157877
District of Columbia,2020-04-13,80,2,1955,52,705749,2020-04-07,1.08087774333381,0.036879072688563
District of Columbia,2020-04-14,103,15,2058,67,705749,2020-04-08,1.04398157857563,0.0358504745962979
District of Columbia,2020-04-15,139,5,2197,72,705749,2020-04-09,0.921853537807554,0.0334832282902827
District of Columbia,2020-04-16,153,9,2350,81,705749,2020-04-10,1.01378635942814,0.0352315114525355
District of Columbia,2020-04-17,126,5,2476,86,705749,2020-04-11,1.00732997116517,0.0352420146568235
District of Columbia,2020-04-18,190,5,2666,91,705749,2020-04-12,1.09262683656044,0.0366455279349182
District of Columbia,2020-04-19,127,5,2793,96,705749,2020-04-13,1.115771793649,0.0368059153283621
District of Columbia,2020-04-20,134,9,2927,105,705749,2020-04-14,1.15339899071029,0.0369762740486321
District of Columbia,2020-04-21,171,7,3098,112,705749,2020-04-15,1.1977023603247,0.0371213310891761
District of Columbia,2020-04-22,108,15,3206,127,705749,2020-04-16,1.11772335716014,0.0351701029529926
District of Columbia,2020-04-23,155,12,3361,139,705749,2020-04-17,1.0840574725881,0.0340770546849646
District of Columbia,2020-04-24,167,14,3528,153,705749,2020-04-18,1.10540047626472,0.034064770060639
District of Columbia,2020-04-25,171,12,3699,165,705749,2020-04-19,1.06324195293919,0.0330652518597878
District of Columbia,2020-04-26,142,13,3841,178,705749,2020-04-20,1.05977575610612,0.0327209750034536
District of Columbia,2020-04-27,51,7,3892,185,705749,2020-04-21,0.963530931094174,0.0310010995459713
District of Columbia,2020-04-28,102,5,3994,190,705749,2020-04-22,0.894227610316149,0.0298573908665062
District of Columbia,2020-04-29,112,15,4106,205,705749,2020-04-23,0.914999992270091,0.0304830694053436
District of Columbia,2020-04-30,217,19,4323,224,705749,2020-04-24,0.999765352945247,0.0322169882391929
District of Columbia,2020-05-01,335,7,4658,231,705749,2020-04-25,1.18350849151373,0.0351916861500063
District of Columbia,2020-05-02,139,9,4797,240,705749,2020-04-26,1.12242060476915,0.033857647911815
District of Columbia,2020-05-03,219,11,5016,251,705749,2020-04-27,1.16146799549326,0.0338690945420437
District of Columbia,2020-05-04,154,7,5170,258,705749,2020-04-28,1.22529488288115,0.034261419114363
District of Columbia,2020-05-05,152,6,5322,264,705749,2020-04-29,1.21939329315476,0.0334488592877691
District of Columbia,2020-05-06,139,13,5461,277,705749,2020-04-30,1.18614931417211,0.032211393799319
District of Columbia,2020-05-07,193,8,5654,285,705749,2020-05-01,1.116805468523,0.0306002813403776
District of Columbia,2020-05-08,245,19,5899,304,705749,2020-05-02,1.00979590969679,0.0286531787620955
District of Columbia,2020-05-09,203,7,6102,311,705749,2020-05-03,1.05034691688211,0.0290643875935776
District of Columbia,2020-05-10,170,12,6272,323,705749,2020-05-04,1.00464904485568,0.0283365345656955
Florida,2020-03-08,3,2,10,2,21477737,2020-03-02,4.00929605913396,1.20884824559981
Florida,2020-03-09,3,0,13,2,21477737,2020-03-03,3.06484791209186,0.850035869118918
Florida,2020-03-10,2,0,15,2,21477737,2020-03-04,2.34005187806402,0.62540517107089
Florida,2020-03-11,9,0,24,2,21477737,2020-03-05,3.00336930975582,0.626245791820736
Florida,2020-03-12,6,0,30,2,21477737,2020-03-06,2.74324310342686,0.518424216961465
Florida,2020-03-13,20,0,50,2,21477737,2020-03-07,3.46863212151712,0.500653922269423
Florida,2020-03-14,26,0,76,2,21477737,2020-03-08,3.54207946858616,0.423359471739015
Florida,2020-03-15,24,1,100,3,21477737,2020-03-09,3.09050562308755,0.323973018248651
Florida,2020-03-16,1,0,101,3,21477737,2020-03-10,2.11609434170371,0.224305551609938
Florida,2020-03-17,89,2,190,5,21477737,2020-03-11,3.27365715196539,0.246761192393924
Florida,2020-03-18,116,2,306,7,21477737,2020-03-12,3.84271544869245,0.228425723208641
Florida,2020-03-19,126,2,432,9,21477737,2020-03-13,3.57229601471788,0.177948739494735
Florida,2020-03-20,132,2,564,11,21477737,2020-03-14,3.0200021846179,0.133077196336014
Florida,2020-03-21,199,2,763,13,21477737,2020-03-15,2.83496102485973,0.108081875809941
Florida,2020-03-22,241,0,1004,13,21477737,2020-03-16,2.72031977535081,0.0904264890551098
Florida,2020-03-23,223,5,1227,18,21477737,2020-03-17,2.50983007201795,0.0747622495499497
Florida,2020-03-24,185,0,1412,18,21477737,2020-03-18,2.06919457163572,0.059168165177497
Florida,2020-03-25,270,5,1682,23,21477737,2020-03-19,1.86954151255535,0.0503811576976649
Florida,2020-03-26,675,6,2357,29,21477737,2020-03-20,2.19540476657622,0.0500249267518122
Florida,2020-03-27,543,6,2900,35,21477737,2020-03-21,2.17852980558216,0.0450644577760225
Florida,2020-03-28,863,19,3763,54,21477737,2020-03-22,2.24273707496383,0.0409397668244039
Florida,2020-03-29,483,2,4246,56,21477737,2020-03-23,1.9389188874387,0.0340475735628169
Florida,2020-03-30,1227,7,5473,63,21477737,2020-03-24,2.08797707435994,0.0320394162965211
Florida,2020-03-31,1268,22,6741,85,21477737,2020-03-25,2.16229285420275,0.0296176712733772
Florida,2020-04-01,215,2,6956,87,21477737,2020-03-26,1.73028807852103,0.0238235887510777
Florida,2020-04-02,2052,77,9008,164,21477737,2020-03-27,1.84355781583645,0.0226037576243194
Florida,2020-04-03,1260,6,10268,170,21477737,2020-03-28,1.7538915363624,0.0204314154175542
Florida,2020-04-04,1269,25,11537,195,21477737,2020-03-29,1.58555396438281,0.017981703362476
Florida,2020-04-05,813,26,12350,221,21477737,2020-03-30,1.45537927462757,0.0161658921260596
Florida,2020-04-06,974,15,13324,236,21477737,2020-03-31,1.27467639257877,0.0143849977118294
Florida,2020-04-07,1221,47,14545,283,21477737,2020-04-01,1.1807436681844,0.0133650064173288
Florida,2020-04-08,911,26,15456,309,21477737,2020-04-02,1.22979586441308,0.0133382244161699
Florida,2020-04-09,908,45,16364,354,21477737,2020-04-03,1.01830817117515,0.0118721356631185
Florida,2020-04-10,1167,36,17531,390,21477737,2020-04-04,0.982578041902033,0.0115286681097565
Florida,2020-04-11,963,48,18494,438,21477737,2020-04-05,0.943893295593953,0.0113156808269096
Florida,2020-04-12,1401,23,19895,461,21477737,2020-04-06,1.03301586068723,0.0118918271820602
Florida,2020-04-13,1124,38,21019,499,21477737,2020-04-07,1.05497313365578,0.0120256585995335
Florida,2020-04-14,609,72,21628,571,21477737,2020-04-08,0.960322924997076,0.011409799696683
Florida,2020-04-15,883,25,22511,596,21477737,2020-04-09,0.956592828425011,0.0113880098622025
Florida,2020-04-16,832,72,23343,668,21477737,2020-04-10,0.956200752710878,0.0114451468643124
Florida,2020-04-17,1416,57,24759,725,21477737,2020-04-11,0.999991696116028,0.0117613529022692
Florida,2020-04-18,733,23,25492,748,21477737,2020-04-12,0.972167506922663,0.0116204542354841
Florida,2020-04-19,822,26,26314,774,21477737,2020-04-13,0.894573951499073,0.0111647430902431
Florida,2020-04-20,745,48,27059,822,21477737,2020-04-14,0.85604217461152,0.011013890228683
Florida,2020-04-21,810,45,27869,867,21477737,2020-04-15,0.911363423053693,0.011535321741931
Florida,2020-04-22,440,26,28309,893,21477737,2020-04-16,0.868865782392026,0.0114097502935403
Florida,2020-04-23,1339,94,29648,987,21477737,2020-04-17,0.968821647957117,0.012200197218529
Florida,2020-04-24,885,59,30533,1046,21477737,2020-04-18,0.902583513671824,0.0118771270532624
Florida,2020-04-25,306,9,30839,1055,21477737,2020-04-19,0.848075556528354,0.0115968181421072
Florida,2020-04-26,693,20,31532,1075,21477737,2020-04-20,0.853016914892606,0.0118076642265947
Florida,2020-04-27,606,13,32138,1088,21477737,2020-04-21,0.859580379607573,0.0120602035491491
Florida,2020-04-28,710,83,32848,1171,21477737,2020-04-22,0.87064864944335,0.0123375310677175
Florida,2020-04-29,345,47,33193,1218,21477737,2020-04-23,0.880555500534254,0.0125986627413485
Florida,2020-04-30,497,50,33690,1268,21477737,2020-04-24,0.749536611506885,0.0117880231582747
Florida,2020-05-01,1038,46,34728,1314,21477737,2020-04-25,0.813541068049996,0.0125591932060019
Florida,2020-05-02,735,50,35463,1364,21477737,2020-04-26,0.943802758951894,0.0138779517750782
Florida,2020-05-03,615,15,36078,1379,21477737,2020-04-27,0.95106100827555,0.0141041169253102
Florida,2020-05-04,819,20,36897,1399,21477737,2020-04-28,1.00594683273298,0.0145804709256225
Florida,2020-05-05,542,72,37439,1471,21477737,2020-04-29,0.974234156423814,0.0143768059882259
Florida,2020-05-06,563,68,38002,1539,21477737,2020-04-30,1.02276270195663,0.0147469546136501
Florida,2020-05-07,826,61,38828,1600,21477737,2020-05-01,1.09257821889381,0.0152409918041316
Florida,2020-05-08,371,69,39199,1669,21477737,2020-05-02,0.937008575086534,0.0140117592910921
Florida,2020-05-09,802,46,40001,1715,21477737,2020-05-03,0.950245066525102,0.014104429752139
Florida,2020-05-10,595,6,40596,1721,21477737,2020-05-04,0.959556044596549,0.0142741144593468
Georgia,2020-03-08,0,0,5,0,10617423,2020-03-02,2.66442226793318,1.08774583595757
Georgia,2020-03-09,5,0,10,0,10617423,2020-03-03,3.6856276665204,1.11125855334557
Georgia,2020-03-10,7,0,17,0,10617423,2020-03-04,3.82226059848006,0.955565149620015
Georgia,2020-03-11,6,0,23,0,10617423,2020-03-05,3.47470565124808,0.740809733970978
Georgia,2020-03-12,8,1,31,1,10617423,2020-03-06,3.22008460132425,0.587904324406774
Georgia,2020-03-13,11,0,42,1,10617423,2020-03-07,3.00498762894091,0.475130262404109
Georgia,2020-03-14,31,0,73,1,10617423,2020-03-08,3.71734494044025,0.447515741868968
Georgia,2020-03-15,26,0,99,1,10617423,2020-03-09,3.45886178793869,0.354871731727965
Georgia,2020-03-16,22,0,121,1,10617423,2020-03-10,2.73347280118923,0.258288901696636
Georgia,2020-03-17,25,0,146,1,10617423,2020-03-11,2.30437589585181,0.202107135895465
Georgia,2020-03-18,51,2,197,3,10617423,2020-03-12,2.41803081269861,0.182785948368341
Georgia,2020-03-19,90,7,287,10,10617423,2020-03-13,2.78278785552353,0.173585537161008
Georgia,2020-03-20,198,4,485,14,10617423,2020-03-14,3.59898421147202,0.170800232045283
Georgia,2020-03-21,70,6,555,20,10617423,2020-03-15,2.67261667167436,0.121608269320409
Georgia,2020-03-22,66,5,621,25,10617423,2020-03-16,2.08341452879772,0.0911013565644773
Georgia,2020-03-23,151,0,772,25,10617423,2020-03-17,2.07849852762331,0.0814002846022769
Georgia,2020-03-24,254,7,1026,32,10617423,2020-03-18,2.30447324161508,0.0776396762000841
Georgia,2020-03-25,221,8,1247,40,10617423,2020-03-19,2.19444417772299,0.067689792022124
Georgia,2020-03-26,278,8,1525,48,10617423,2020-03-20,2.06228884191533,0.0585886969095551
Georgia,2020-03-27,475,16,2000,64,10617423,2020-03-21,2.05712809527239,0.0528337862661107
Georgia,2020-03-28,366,5,2366,69,10617423,2020-03-22,2.01876371433621,0.0474248966754826
Georgia,2020-03-29,285,11,2651,80,10617423,2020-03-23,1.86398276452308,0.041360609556257
Georgia,2020-03-30,157,7,2808,87,10617423,2020-03-24,1.57001105171653,0.0347862164575362
Georgia,2020-03-31,1121,24,3929,111,10617423,2020-03-25,1.96172362600158,0.0364031962126235
Georgia,2020-04-01,709,28,4638,139,10617423,2020-03-26,1.95918201306103,0.0336392932740239
Georgia,2020-04-02,710,24,5348,163,10617423,2020-03-27,1.833091700162,0.029643211266054
Georgia,2020-04-03,483,21,5831,184,10617423,2020-03-28,1.55350795763319,0.0250957819361929
Georgia,2020-04-04,329,17,6160,201,10617423,2020-03-29,1.35301642628717,0.0219632790304981
Georgia,2020-04-05,487,10,6647,211,10617423,2020-03-30,1.30830395057685,0.0206938634324663
Georgia,2020-04-06,667,18,7314,229,10617423,2020-03-31,1.38036521794927,0.0205612838454031
Georgia,2020-04-07,1508,100,8822,329,10617423,2020-04-01,1.39304574110469,0.0199128487187754
Georgia,2020-04-08,1079,33,9901,362,10617423,2020-04-02,1.38150655533619,0.0190412304725755
Georgia,2020-04-09,665,17,10566,379,10617423,2020-04-03,1.26441113650182,0.0175022814712416
Georgia,2020-04-10,919,37,11485,416,10617423,2020-04-04,1.28406735891569,0.0170754242055844
Georgia,2020-04-11,674,13,12159,429,10617423,2020-04-05,1.2867025384717,0.0166112583434123
Georgia,2020-04-12,293,4,12452,433,10617423,2020-04-06,1.17190973550977,0.0153799755968509
Georgia,2020-04-13,863,32,13315,465,10617423,2020-04-07,1.15673707005829,0.0149309230810809
Georgia,2020-04-14,1263,60,14578,525,10617423,2020-04-08,1.07257584441449,0.014136109389729
Georgia,2020-04-15,409,27,14987,552,10617423,2020-04-09,0.926077390208824,0.0129842363534074
Georgia,2020-04-16,682,35,15669,587,10617423,2020-04-10,0.932877577067156,0.0130577792259636
Georgia,2020-04-17,1525,63,17194,650,10617423,2020-04-11,1.06177957185497,0.0140512936949724
Georgia,2020-04-18,475,23,17669,673,10617423,2020-04-12,1.02275030569889,0.0137769921981467
Georgia,2020-04-19,632,14,18301,687,10617423,2020-04-13,1.07492677836503,0.0140540323552993
Georgia,2020-04-20,1106,88,19407,775,10617423,2020-04-14,1.10716379511524,0.0141839204412323
Georgia,2020-04-21,474,23,19881,798,10617423,2020-04-15,0.943628105076709,0.0129568404155506
Georgia,2020-04-22,1333,50,21214,848,10617423,2020-04-16,1.1051776767998,0.0140041838028741
Georgia,2020-04-23,669,33,21883,881,10617423,2020-04-17,1.0955329601022,0.0138964824008344
Georgia,2020-04-24,608,18,22491,899,10617423,2020-04-18,0.912022447324183,0.0125299561355728
Georgia,2020-04-25,731,8,23222,907,10617423,2020-04-19,0.959176159122962,0.0128705005614037
Georgia,2020-04-26,264,9,23486,916,10617423,2020-04-20,0.909642381488454,0.0126314855709254
Georgia,2020-04-27,816,79,24302,995,10617423,2020-04-21,0.871721610352147,0.0124582519011286
Georgia,2020-04-28,620,41,24922,1036,10617423,2020-04-22,0.921495315914337,0.0129775201332312
Georgia,2020-04-29,853,65,25775,1101,10617423,2020-04-23,0.853138833741043,0.0126311260883486
Georgia,2020-04-30,489,31,26264,1132,10617423,2020-04-24,0.841275925086967,0.0127087335439432
Georgia,2020-05-01,1225,37,27489,1169,10617423,2020-04-25,0.994946249828615,0.0140720720809743
Georgia,2020-05-02,842,8,28331,1177,10617423,2020-04-26,1.03339641678845,0.0144562783321123
Georgia,2020-05-03,334,7,28665,1184,10617423,2020-04-27,1.04171596022314,0.0144738623547421
Georgia,2020-05-04,786,62,29451,1246,10617423,2020-04-28,1.02678951600311,0.0143079630905576
Georgia,2020-05-05,547,53,29998,1299,10617423,2020-04-29,1.00487325900608,0.0141028766545037
Georgia,2020-05-06,745,28,30743,1327,10617423,2020-04-30,0.980671097744206,0.0139119778530019
Georgia,2020-05-07,875,28,31618,1355,10617423,2020-05-01,1.05930911121586,0.014475813196962
Georgia,2020-05-08,563,45,32181,1400,10617423,2020-05-02,0.923126448944261,0.0134752216413179
Georgia,2020-05-09,407,3,32588,1403,10617423,2020-05-03,0.840698561514621,0.0128836072100289
Georgia,2020-05-10,992,3,33580,1406,10617423,2020-05-04,1.00008076111929,0.0142635994858631
Grand Princess,2020-03-08,0,0,0,0,0,2020-03-02,5,5
Grand Princess,2020-03-09,0,0,0,0,0,2020-03-03,5,5
Grand Princess,2020-03-10,0,0,0,0,0,2020-03-04,5,5
Grand Princess,2020-03-11,0,0,0,0,0,2020-03-05,5,5
Grand Princess,2020-03-12,0,0,0,0,0,2020-03-06,5,5
Grand Princess,2020-03-13,0,0,0,0,0,2020-03-07,5,5
Grand Princess,2020-03-14,0,0,0,0,0,2020-03-08,5,5
Grand Princess,2020-03-15,0,0,0,0,0,2020-03-09,5,5
Grand Princess,2020-03-16,20,0,20,0,0,2020-03-10,105,22.9128784747792
Grand Princess,2020-03-17,1,0,21,0,0,2020-03-11,7.84758417654755,1.67311056810089
Grand Princess,2020-03-18,0,0,21,0,0,2020-03-12,3.03154381235794,0.646327312458131
Grand Princess,2020-03-19,1,1,22,1,0,2020-03-13,2.14508745594868,0.44728165397832
Grand Princess,2020-03-20,1,0,23,1,0,2020-03-14,1.78354829981853,0.364065272180321
Grand Princess,2020-03-21,0,0,23,1,0,2020-03-15,1.52289144207662,0.310858913894913
Grand Princess,2020-03-22,7,0,30,1,0,2020-03-16,1.76050044994427,0.316195215030514
Grand Princess,2020-03-23,-2,0,28,1,0,2020-03-17,0.552502681198381,0.166585826290943
Grand Princess,2020-03-24,0,0,28,1,0,2020-03-18,0.503437433166856,0.159200894819606
Grand Princess,2020-03-25,0,0,28,1,0,2020-03-19,0.576977901012483,0.182456432678262
Grand Princess,2020-03-26,0,0,28,1,0,2020-03-20,0.587821220870053,0.195940406956684
Grand Princess,2020-03-27,0,2,28,3,0,2020-03-21,0.585568370012484,0.20702968264209
Grand Princess,2020-03-28,75,0,103,3,0,2020-03-22,6.81761051219453,0.748329972768966
Grand Princess,2020-03-29,0,0,103,3,0,2020-03-23,3.67133741294588,0.421131283438715
Grand Princess,2020-03-30,0,0,103,3,0,2020-03-24,2.16687000639708,0.248557036359847
Grand Princess,2020-03-31,0,0,103,3,0,2020-03-25,1.68716628537904,0.193531245760951
Grand Princess,2020-04-01,0,0,103,3,0,2020-03-26,1.44651934827635,0.165927148921393
Grand Princess,2020-04-02,0,0,103,3,0,2020-03-27,1.30648262188512,0.149863834744456
Grand Princess,2020-04-03,0,0,103,3,0,2020-03-28,1.21788161838711,0.139700602624873
Grand Princess,2020-04-04,0,0,103,3,0,2020-03-29,0.0152476971194935,0.0152476971194935
Grand Princess,2020-04-05,0,0,103,3,0,2020-03-30,0.017178954521046,0.017178954521046
Grand Princess,2020-04-06,0,0,103,3,0,2020-03-31,0.0228342986669301,0.0228342986669301
Grand Princess,2020-04-07,0,0,103,3,0,2020-04-01,0.0303400566765903,0.0303400566765903
Grand Princess,2020-04-08,0,0,103,3,0,2020-04-02,0.0402930248441614,0.0402930248441614
Grand Princess,2020-04-09,0,0,103,3,0,2020-04-03,0.0534759021306679,0.0534759021306679
Grand Princess,2020-04-10,0,0,103,3,0,2020-04-04,0.0709102238852106,0.0709102238852106
Grand Princess,2020-04-11,0,0,103,3,0,2020-04-05,0.0939205957992908,0.0939205957992908
Grand Princess,2020-04-12,0,-3,103,0,0,2020-04-06,0.12420967486436,0.12420967486436
Grand Princess,2020-04-13,0,0,103,0,0,2020-04-07,0.163940471374034,0.163940471374034
Grand Princess,2020-04-14,0,0,103,0,0,2020-04-08,0.2158173857711,0.2158173857711
Grand Princess,2020-04-15,0,0,103,0,0,2020-04-09,0.283148964434623,0.283148964434623
Grand Princess,2020-04-16,0,0,103,0,0,2020-04-10,0.369862927384803,0.369862927384803
Grand Princess,2020-04-17,0,0,103,0,0,2020-04-11,0.480428090776282,0.480428090776282
Grand Princess,2020-04-18,0,0,103,0,0,2020-04-12,0.619621987116739,0.619621987116739
Grand Princess,2020-04-19,0,0,103,0,0,2020-04-13,0.792076614782278,0.792076614782278
Grand Princess,2020-04-20,0,0,103,0,0,2020-04-14,1.0015546833652,1.0015546833652
Grand Princess,2020-04-21,0,0,103,0,0,2020-04-15,1.24997603367118,1.24997603367118
Grand Princess,2020-04-22,0,0,103,0,0,2020-04-16,1.53633925698904,1.53633925698904
Grand Princess,2020-04-23,0,3,103,3,0,2020-04-17,1.85584006840877,1.85584006840877
Grand Princess,2020-04-24,0,0,103,3,0,2020-04-18,2.19958982740902,2.19958982740902
Grand Princess,2020-04-25,0,0,103,3,0,2020-04-19,2.55526510752352,2.55526510752352
Grand Princess,2020-04-26,0,0,103,3,0,2020-04-20,2.90871607344183,2.90871607344183
Grand Princess,2020-04-27,0,0,103,3,0,2020-04-21,3.24614038305405,3.24614038305405
Grand Princess,2020-04-28,0,0,103,3,0,2020-04-22,3.55614671907944,3.55614671907944
Grand Princess,2020-04-29,0,0,103,3,0,2020-04-23,3.83108889429164,3.83108889429164
Grand Princess,2020-04-30,0,0,103,3,0,2020-04-24,4.06740595482808,4.06740595482808
Grand Princess,2020-05-01,0,0,103,3,0,2020-04-25,4.26511161825571,4.26511161825571
Grand Princess,2020-05-02,0,0,103,3,0,2020-04-26,4.42681102840279,4.42681102840279
Grand Princess,2020-05-03,0,0,103,3,0,2020-04-27,4.55662984539131,4.55662984539131
Grand Princess,2020-05-04,0,0,103,3,0,2020-04-28,4.65930942434463,4.65930942434463
Grand Princess,2020-05-05,0,0,103,3,0,2020-04-29,4.73956865826142,4.73956865826142
Grand Princess,2020-05-06,0,0,103,3,0,2020-04-30,4.80172516783932,4.80172516783932
Grand Princess,2020-05-07,0,0,103,3,0,2020-05-01,4.84951794112316,4.84951794112316
Grand Princess,2020-05-08,0,0,103,3,0,2020-05-02,4.88606394890262,4.88606394890262
Grand Princess,2020-05-09,0,0,103,3,0,2020-05-03,4.91389200316959,4.91389200316959
Grand Princess,2020-05-10,0,0,103,3,0,2020-05-04,4.93501365678581,4.93501365678581
Guam,2020-03-08,0,0,0,0,164229,2020-03-02,5,5
Guam,2020-03-09,0,0,0,0,164229,2020-03-03,5,5
Guam,2020-03-10,0,0,0,0,164229,2020-03-04,5,5
Guam,2020-03-11,0,0,0,0,164229,2020-03-05,5,5
Guam,2020-03-12,0,0,0,0,164229,2020-03-06,5,5
Guam,2020-03-13,0,0,0,0,164229,2020-03-07,5,5
Guam,2020-03-14,0,0,0,0,164229,2020-03-08,5,5
Guam,2020-03-15,0,0,0,0,164229,2020-03-09,5,5
Guam,2020-03-16,3,0,3,0,164229,2020-03-10,20,10
Guam,2020-03-17,0,0,3,0,164229,2020-03-11,6.77378760015775,3.38689380007887
Guam,2020-03-18,2,0,5,0,164229,2020-03-12,4.84250282632051,1.97694350041177
Guam,2020-03-19,7,0,12,0,164229,2020-03-13,6.54346282501469,1.81483005651407
Guam,2020-03-20,2,0,14,0,164229,2020-03-14,4.05791076354981,1.04774805384162
Guam,2020-03-21,1,0,15,0,164229,2020-03-15,2.63585290621066,0.658963226552666
Guam,2020-03-22,12,1,27,1,164229,2020-03-16,3.40600845707646,0.643675095771937
Guam,2020-03-23,2,0,29,1,164229,2020-03-17,2.34429725468079,0.451160217016818
Guam,2020-03-24,3,0,32,1,164229,2020-03-18,1.96275417264348,0.35834824506474
Guam,2020-03-25,5,0,37,1,164229,2020-03-19,1.7946613854038,0.312410447205299
Guam,2020-03-26,8,0,45,1,164229,2020-03-20,1.58394134755092,0.271643700053701
Guam,2020-03-27,6,0,51,1,164229,2020-03-21,1.5661453189679,0.254062319340265
Guam,2020-03-28,4,0,55,1,164229,2020-03-22,1.51823594848809,0.237108619509901
Guam,2020-03-29,1,0,56,1,164229,2020-03-23,1.00236493011129,0.183005961024681
Guam,2020-03-30,2,0,58,1,164229,2020-03-24,0.966187748331331,0.176400941515398
Guam,2020-03-31,11,1,69,2,164229,2020-03-25,1.24223065618299,0.201516422418204
Guam,2020-04-01,8,1,77,3,164229,2020-03-26,1.3104896034276,0.204664091283196
Guam,2020-04-02,5,0,82,3,164229,2020-03-27,1.14643306118397,0.185976000416553
Guam,2020-04-03,2,1,84,4,164229,2020-03-28,0.985256398717031,0.168970078382574
Guam,2020-04-04,9,0,93,4,164229,2020-03-29,1.12531606255359,0.180194783543917
Guam,2020-04-05,19,0,112,4,164229,2020-03-30,1.63110185305461,0.216044718203958
Guam,2020-04-06,1,0,113,4,164229,2020-03-31,1.46991122924495,0.196425150314512
Guam,2020-04-07,8,0,121,4,164229,2020-04-01,1.24805018978253,0.171432877904796
Guam,2020-04-08,0,0,121,4,164229,2020-04-02,0.994687097813564,0.148279197803541
Guam,2020-04-09,7,0,128,4,164229,2020-04-03,1.02332701008377,0.149267585625435
Guam,2020-04-10,2,0,130,4,164229,2020-04-04,1.02711223021259,0.149819716727343
Guam,2020-04-11,3,1,133,5,164229,2020-04-05,0.893852404541756,0.139596292590462
Guam,2020-04-12,0,0,133,5,164229,2020-04-06,0.487047412567794,0.1038388572586
Guam,2020-04-13,0,0,133,5,164229,2020-04-07,0.506491439655984,0.110525493384319
Guam,2020-04-14,0,0,133,5,164229,2020-04-08,0.358165767803706,0.0993373108409377
Guam,2020-04-15,2,0,135,5,164229,2020-04-09,0.479931713206231,0.123917835504302
Guam,2020-04-16,0,0,135,5,164229,2020-04-10,0.298737927362894,0.105619807117958
Guam,2020-04-17,1,0,136,5,164229,2020-04-11,0.307802124699101,0.116338267853016
Guam,2020-04-18,0,0,136,5,164229,2020-04-12,0.213342414696632,0.106671207348316
Guam,2020-04-19,0,0,136,5,164229,2020-04-13,0.262468420032686,0.131234210016343
Guam,2020-04-20,0,0,136,5,164229,2020-04-14,0.326591051387616,0.163295525693808
Guam,2020-04-21,0,0,136,5,164229,2020-04-15,0.400033366428461,0.200016683214231
Guam,2020-04-22,0,0,136,5,164229,2020-04-16,0.240690720972927,0.170194040968636
Guam,2020-04-23,3,0,139,5,164229,2020-04-17,0.737542412463035,0.329838994111307
Guam,2020-04-24,2,0,141,5,164229,2020-04-18,1.0374866115417,0.423552135541045
Guam,2020-04-25,0,0,141,5,164229,2020-04-19,1.08697330749362,0.443754994564122
Guam,2020-04-26,0,0,141,5,164229,2020-04-20,1.10285832519988,0.450240025886688
Guam,2020-04-27,0,0,141,5,164229,2020-04-21,1.11510449430945,0.455239503490405
Guam,2020-04-28,0,0,141,5,164229,2020-04-22,1.12448769698198,0.459070179940539
Guam,2020-04-29,0,0,141,5,164229,2020-04-23,1.13164354393086,0.46199154222424
Guam,2020-04-30,4,0,145,5,164229,2020-04-24,1.32659476182873,0.501405690051399
Guam,2020-05-01,0,0,145,5,164229,2020-04-25,0.928025202463253,0.415025487508168
Guam,2020-05-02,0,0,145,5,164229,2020-04-26,0.938209942773411,0.419580241841507
Guam,2020-05-03,0,0,145,5,164229,2020-04-27,0.990365426736927,0.442904883349871
Guam,2020-05-04,0,0,145,5,164229,2020-04-28,1.03354156105952,0.462213837620067
Guam,2020-05-05,0,0,145,5,164229,2020-04-29,1.06854885414296,0.477869575028632
Guam,2020-05-06,4,0,149,5,164229,2020-04-30,1.97362343891197,0.657874479637322
Guam,2020-05-07,0,0,149,5,164229,2020-05-01,1.00173913046674,0.447991358289033
Guam,2020-05-08,2,0,151,5,164229,2020-05-02,1.3287605447434,0.502224279049393
Guam,2020-05-09,0,0,151,5,164229,2020-05-03,1.33004763712453,0.502710754242942
Guam,2020-05-10,0,0,151,5,164229,2020-05-04,1.27369000339057,0.481409570908637
Hawaii,2020-03-08,0,0,1,0,1415872,2020-03-02,6.05747589181412,4.2832822799758
Hawaii,2020-03-09,0,0,1,0,1415872,2020-03-03,3.66070465155515,2.58850908303578
Hawaii,2020-03-10,2,0,3,0,1415872,2020-03-04,5.64340827261365,2.82170413630682
Hawaii,2020-03-11,-1,0,2,0,1415872,2020-03-05,3.66565877386782,1.83282938693391
Hawaii,2020-03-12,0,0,2,0,1415872,2020-03-06,2.47633325063267,1.23816662531634
Hawaii,2020-03-13,0,0,2,0,1415872,2020-03-07,1.99091393600786,0.995456968003931
Hawaii,2020-03-14,2,0,4,0,1415872,2020-03-08,2.16911610889987,0.970058214117989
Hawaii,2020-03-15,2,0,6,0,1415872,2020-03-09,2.63389275152588,0.995517885793305
Hawaii,2020-03-16,2,0,8,0,1415872,2020-03-10,2.72619050057717,0.908730166859057
Hawaii,2020-03-17,2,0,10,0,1415872,2020-03-11,2.10180128346583,0.700600427821944
Hawaii,2020-03-18,5,0,15,0,1415872,2020-03-12,2.66375275585226,0.711917869676718
Hawaii,2020-03-19,10,0,25,0,1415872,2020-03-13,3.61537780533508,0.73798590420452
Hawaii,2020-03-20,11,0,36,0,1415872,2020-03-14,3.65697778214587,0.618142066405648
Hawaii,2020-03-21,0,0,36,0,1415872,2020-03-15,2.29329112028613,0.399210742643425
Hawaii,2020-03-22,17,0,53,0,1415872,2020-03-16,2.51932224469335,0.363632844037279
Hawaii,2020-03-23,3,0,56,0,1415872,2020-03-17,2.01872944177973,0.288389920254247
Hawaii,2020-03-24,34,1,90,1,1415872,2020-03-18,2.69095659836353,0.298995177595948
Hawaii,2020-03-25,1,-1,91,0,1415872,2020-03-19,1.98636200086345,0.226366958675919
Hawaii,2020-03-26,4,0,95,0,1415872,2020-03-20,1.46267031261971,0.173587029900174
Hawaii,2020-03-27,11,0,106,0,1415872,2020-03-21,1.29955387118445,0.154228669815653
Hawaii,2020-03-28,43,0,149,0,1415872,2020-03-22,1.94863117773047,0.182506031306809
Hawaii,2020-03-29,0,0,149,0,1415872,2020-03-23,1.44760982490756,0.146982508432964
Hawaii,2020-03-30,26,0,175,0,1415872,2020-03-24,1.5732729278681,0.143619511950926
Hawaii,2020-03-31,29,0,204,0,1415872,2020-03-25,1.36547021935453,0.127330754505706
Hawaii,2020-04-01,20,1,224,1,1415872,2020-03-26,1.45237732262359,0.125466291104491
Hawaii,2020-04-02,32,0,256,1,1415872,2020-03-27,1.61696453461339,0.127040731929253
Hawaii,2020-04-03,63,2,319,3,1415872,2020-03-28,1.91008667666773,0.130570837156737
Hawaii,2020-04-04,32,0,351,3,1415872,2020-03-29,1.54933637347192,0.108742095532066
Hawaii,2020-04-05,20,1,371,4,1415872,2020-03-30,1.48652192492845,0.0995448708634208
Hawaii,2020-04-06,16,1,387,5,1415872,2020-03-31,1.28633075558798,0.0881379310832805
Hawaii,2020-04-07,23,0,410,5,1415872,2020-04-01,1.16060590863399,0.0806676869966649
Hawaii,2020-04-08,0,0,410,5,1415872,2020-04-02,1.00545573138782,0.0735262050044486
Hawaii,2020-04-09,32,1,442,6,1415872,2020-04-03,0.992538909689884,0.0725816334529421
Hawaii,2020-04-10,0,0,442,6,1415872,2020-04-04,0.660074641374063,0.0592764526621019
Hawaii,2020-04-11,23,2,465,8,1415872,2020-04-05,0.641580452787833,0.0598276857097652
Hawaii,2020-04-12,34,1,499,9,1415872,2020-04-06,0.785890969937534,0.0691938416754626
Hawaii,2020-04-13,5,0,504,9,1415872,2020-04-07,0.768455046868632,0.0707420211143129
Hawaii,2020-04-14,7,0,511,9,1415872,2020-04-08,0.699484280138345,0.069259264132979
Hawaii,2020-04-15,13,0,524,9,1415872,2020-04-09,0.841714840906185,0.0784903136312248
Hawaii,2020-04-16,6,0,530,9,1415872,2020-04-10,0.687184748825676,0.0728414376927919
Hawaii,2020-04-17,11,0,541,9,1415872,2020-04-11,0.817503470175014,0.0817503470175014
Hawaii,2020-04-18,33,0,574,9,1415872,2020-04-12,0.954239726842779,0.0909831880716522
Hawaii,2020-04-19,6,1,580,10,1415872,2020-04-13,0.728359841053908,0.0804338887792157
Hawaii,2020-04-20,4,0,584,10,1415872,2020-04-14,0.749330408972927,0.0832589343303252
Hawaii,2020-04-21,2,0,586,10,1415872,2020-04-15,0.750380542043068,0.0860745513675002
Hawaii,2020-04-22,6,2,592,12,1415872,2020-04-16,0.723332996097452,0.0870790598002771
Hawaii,2020-04-23,4,0,596,12,1415872,2020-04-17,0.748917582637563,0.0914948449394983
Hawaii,2020-04-24,5,1,601,13,1415872,2020-04-18,0.726900887489987,0.093070121654671
Hawaii,2020-04-25,4,0,605,13,1415872,2020-04-19,0.40643394833939,0.0718480502438015
Hawaii,2020-04-26,1,1,606,14,1415872,2020-04-20,0.383781018017733,0.0738586913541356
Hawaii,2020-04-27,1,2,607,16,1415872,2020-04-21,0.4001904104429,0.0816885254616728
Hawaii,2020-04-28,2,0,609,16,1415872,2020-04-22,0.468860184228574,0.0957056843389435
Hawaii,2020-04-29,4,0,613,16,1415872,2020-04-23,0.497373840572644,0.106040459106629
Hawaii,2020-04-30,5,0,618,16,1415872,2020-04-24,0.593625419797084,0.123779456578374
Hawaii,2020-05-01,1,0,619,16,1415872,2020-04-25,0.550488194999788,0.126290653242957
Hawaii,2020-05-02,1,0,620,16,1415872,2020-04-26,0.517236516039528,0.129309129009882
Hawaii,2020-05-03,0,1,620,17,1415872,2020-04-27,0.547874800245479,0.14146066514383
Hawaii,2020-05-04,1,0,621,17,1415872,2020-04-28,0.619279173708073,0.159897195094964
Hawaii,2020-05-05,4,0,625,17,1415872,2020-04-29,0.7822894516573,0.189733061117033
Hawaii,2020-05-06,1,0,626,17,1415872,2020-04-30,0.695832596085914,0.185969083793068
Hawaii,2020-05-07,3,0,629,17,1415872,2020-05-01,0.639825440726781,0.184701695218989
Hawaii,2020-05-08,0,0,629,17,1415872,2020-05-02,0.642741038223244,0.193793714649998
Hawaii,2020-05-09,2,0,631,17,1415872,2020-05-03,0.773484037542104,0.223285608644406
Hawaii,2020-05-10,1,0,632,17,1415872,2020-05-04,0.907587696047842,0.251719536544671
Idaho,2020-03-08,0,0,0,0,1787065,2020-03-02,5,5
Idaho,2020-03-09,0,0,0,0,1787065,2020-03-03,5,5
Idaho,2020-03-10,0,0,0,0,1787065,2020-03-04,5,5
Idaho,2020-03-11,0,0,0,0,1787065,2020-03-05,5,5
Idaho,2020-03-12,0,0,0,0,1787065,2020-03-06,5,5
Idaho,2020-03-13,1,0,1,0,1787065,2020-03-07,10,7.07106781186548
Idaho,2020-03-14,1,0,2,0,1787065,2020-03-08,9.08621383772119,5.24592800512283
Idaho,2020-03-15,2,0,4,0,1787065,2020-03-09,7.39083630900246,3.30528247950063
Idaho,2020-03-16,0,0,4,0,1787065,2020-03-10,3.80090701393397,1.69981729186242
Idaho,2020-03-17,4,0,8,0,1787065,2020-03-11,4.42838128160035,1.47612709386678
Idaho,2020-03-18,1,0,9,0,1787065,2020-03-12,3.23442584548787,1.02281525946575
Idaho,2020-03-19,14,0,23,0,1787065,2020-03-13,5.34351182775557,1.09073978437732
Idaho,2020-03-20,13,0,36,0,1787065,2020-03-14,4.81026021389062,0.801710035648436
Idaho,2020-03-21,6,0,42,0,1787065,2020-03-15,3.16557555284705,0.494379842630727
Idaho,2020-03-22,0,0,42,0,1787065,2020-03-16,2.03848461236615,0.32641877753827
Idaho,2020-03-23,26,0,68,0,1787065,2020-03-17,2.69626425749141,0.334430421560316
Idaho,2020-03-24,13,0,81,0,1787065,2020-03-18,2.38754449281779,0.277546409685877
Idaho,2020-03-25,10,0,91,0,1787065,2020-03-19,2.0535343991346,0.225404683684382
Idaho,2020-03-26,55,3,146,3,1787065,2020-03-20,2.49312899818978,0.223889593355793
Idaho,2020-03-27,59,0,205,3,1787065,2020-03-21,2.69236317111108,0.206494828950428
Idaho,2020-03-28,29,1,234,4,1787065,2020-03-22,2.29610779107038,0.165277455342925
Idaho,2020-03-29,47,1,281,5,1787065,2020-03-23,2.21791773970362,0.143165974485502
Idaho,2020-03-30,59,1,340,6,1787065,2020-03-24,2.01921375567065,0.122208375927545
Idaho,2020-03-31,175,2,515,8,1787065,2020-03-25,2.63089703202278,0.126141857684174
Idaho,2020-04-01,51,1,566,9,1787065,2020-03-26,2.23487923920352,0.102435521980871
Idaho,2020-04-02,210,0,776,9,1787065,2020-03-27,2.30881502596564,0.0919124749385305
Idaho,2020-04-03,115,0,891,9,1787065,2020-03-28,1.99910698529835,0.0762706887356892
Idaho,2020-04-04,131,1,1022,10,1787065,2020-03-29,1.86897593240377,0.0665373051247422
Idaho,2020-04-05,56,0,1078,10,1787065,2020-03-30,1.59264091960469,0.0563788774102872
Idaho,2020-04-06,23,0,1101,10,1787065,2020-03-31,1.32847907539064,0.0481257191888283
Idaho,2020-04-07,69,3,1170,13,1787065,2020-04-01,1.05048288420215,0.0410144659563606
Idaho,2020-04-08,40,2,1210,15,1787065,2020-04-02,1.00053365300667,0.0393959741145254
Idaho,2020-04-09,22,3,1232,18,1787065,2020-04-03,0.707600634996202,0.0331001615896096
Idaho,2020-04-10,122,6,1354,24,1787065,2020-04-04,0.747225560430466,0.0346890757846681
Idaho,2020-04-11,42,1,1396,25,1787065,2020-04-05,0.645519533389456,0.0333344853662526
Idaho,2020-04-12,11,2,1407,27,1787065,2020-04-06,0.611015714025114,0.033635308053223
Idaho,2020-04-13,19,0,1426,27,1787065,2020-04-07,0.661256777299293,0.0366236256478772
Idaho,2020-04-14,38,6,1464,33,1787065,2020-04-08,0.652984591148697,0.0380182327479869
Idaho,2020-04-15,9,6,1473,39,1787065,2020-04-09,0.634187735373082,0.0390315569539396
Idaho,2020-04-16,114,2,1587,41,1787065,2020-04-10,0.932167891400818,0.0494047994347433
Idaho,2020-04-17,22,0,1609,41,1787065,2020-04-11,0.702562987838332,0.0439101867398958
Idaho,2020-04-18,46,2,1655,43,1787065,2020-04-12,0.744811497747873,0.0461912482210741
Idaho,2020-04-19,13,1,1668,44,1787065,2020-04-13,0.803014470953326,0.049610399694664
Idaho,2020-04-20,4,1,1672,45,1787065,2020-04-14,0.797128114347801,0.0507200473299119
Idaho,2020-04-21,64,3,1736,48,1787065,2020-04-15,0.92287065602656,0.0558546730119394
Idaho,2020-04-22,30,3,1766,51,1787065,2020-04-16,1.02485515105383,0.0597707661986874
Idaho,2020-04-23,70,3,1836,54,1787065,2020-04-17,0.874255458514523,0.0552927701148148
Idaho,2020-04-24,34,0,1870,54,1787065,2020-04-18,0.928979173466537,0.0573925250051592
Idaho,2020-04-25,17,2,1887,56,1787065,2020-04-19,0.845940605100002,0.0554194116747301
Idaho,2020-04-26,10,0,1897,56,1787065,2020-04-20,0.857822078211991,0.056563112802078
Idaho,2020-04-27,0,0,1897,56,1787065,2020-04-21,0.873250391507768,0.0580877519825949
Idaho,2020-04-28,55,4,1952,60,1787065,2020-04-22,0.864798673811602,0.0587063592684336
Idaho,2020-04-29,0,0,1952,60,1787065,2020-04-23,0.768407173486091,0.056191497647185
Idaho,2020-04-30,32,0,1984,60,1787065,2020-04-24,0.640294474848903,0.0524549672328197
Idaho,2020-05-01,31,3,2015,63,1787065,2020-04-25,0.675296607688195,0.0558879449075953
Idaho,2020-05-02,46,1,2061,64,1787065,2020-04-26,0.879790829255484,0.06650593542758
Idaho,2020-05-03,0,0,2061,64,1787065,2020-04-27,0.871459790553404,0.0678430526825047
Idaho,2020-05-04,45,0,2106,64,1787065,2020-04-28,1.13960876690288,0.0786404761164285
Idaho,2020-05-05,21,1,2127,65,1787065,2020-04-29,0.950618329590774,0.0716555526837955
Idaho,2020-05-06,31,1,2158,66,1787065,2020-04-30,1.10875640239142,0.0770638971922255
Idaho,2020-05-07,20,1,2178,67,1787065,2020-05-01,1.03792963143435,0.0743276847276402
Idaho,2020-05-08,0,0,2178,67,1787065,2020-05-02,0.85923982032172,0.0670953575520665
Idaho,2020-05-09,27,0,2205,67,1787065,2020-05-03,0.772675717619992,0.0641672257410851
Idaho,2020-05-10,25,0,2230,67,1787065,2020-05-04,0.949150234538406,0.0727964999047228
Illinois,2020-03-08,1,0,7,0,12671821,2020-03-02,2.02113548069479,0.903879265314055
Illinois,2020-03-09,0,0,7,0,12671821,2020-03-03,1.37795962481546,0.688979812407728
Illinois,2020-03-10,5,0,12,0,12671821,2020-03-04,2.90787352906641,0.96929117635547
Illinois,2020-03-11,13,0,25,0,12671821,2020-03-05,5.83247826912366,1.2434885451057
Illinois,2020-03-12,7,0,32,0,12671821,2020-03-06,4.26526183593386,0.806058721032556
Illinois,2020-03-13,14,0,46,0,12671821,2020-03-07,3.82412709580497,0.590075621563513
Illinois,2020-03-14,18,0,64,0,12671821,2020-03-08,3.50447779841569,0.456244148132214
Illinois,2020-03-15,2,0,66,0,12671821,2020-03-09,2.3900946361576,0.308559890723269
Illinois,2020-03-16,17,0,83,0,12671821,2020-03-10,2.3013251211341,0.262260337425488
Illinois,2020-03-17,78,1,161,1,12671821,2020-03-11,3.56556154344195,0.291126880930774
Illinois,2020-03-18,111,0,272,1,12671821,2020-03-12,4.12962634751718,0.262231535299007
Illinois,2020-03-19,150,3,422,4,12671821,2020-03-13,4.11728855288311,0.208220232044071
Illinois,2020-03-20,163,1,585,5,12671821,2020-03-14,3.56639155290268,0.153473056560521
Illinois,2020-03-21,168,1,753,6,12671821,2020-03-15,2.99800812254972,0.114132218665453
Illinois,2020-03-22,296,3,1049,9,12671821,2020-03-16,3.01393361133112,0.0960806942651807
Illinois,2020-03-23,236,3,1285,12,12671821,2020-03-17,2.64455457243916,0.0762464661247725
Illinois,2020-03-24,252,4,1537,16,12671821,2020-03-18,2.24011839322908,0.0603676127396889
Illinois,2020-03-25,328,3,1865,19,12671821,2020-03-19,2.03483343433297,0.0509664877808177
Illinois,2020-03-26,673,7,2538,26,12671821,2020-03-20,2.20764921948163,0.0479810380013722
Illinois,2020-03-27,486,8,3024,34,12671821,2020-03-21,2.05968680743211,0.0416971406060076
Illinois,2020-03-28,467,13,3491,47,12671821,2020-03-22,1.87833865791219,0.0358903654606345
Illinois,2020-03-29,1105,19,4596,66,12671821,2020-03-23,2.03799775495049,0.0342146337669406
Illinois,2020-03-30,460,7,5056,73,12671821,2020-03-24,1.80127007487498,0.0293287120703817
Illinois,2020-03-31,938,26,5994,99,12671821,2020-03-25,1.79441870882179,0.0268753269621087
Illinois,2020-04-01,986,42,6980,141,12671821,2020-03-26,1.76811713814308,0.0247198462833556
Illinois,2020-04-02,715,22,7695,163,12671821,2020-03-27,1.5315876382538,0.0213255962945725
Illinois,2020-04-03,1209,47,8904,210,12671821,2020-03-28,1.54458465328519,0.0201412363488511
Illinois,2020-04-04,1453,34,10357,244,12671821,2020-03-29,1.62070635941429,0.0195578365608299
Illinois,2020-04-05,902,30,11259,274,12671821,2020-03-30,1.39596700778246,0.0171004547671652
Illinois,2020-04-06,1003,33,12262,307,12671821,2020-03-31,1.3682406992273,0.0161170385104879
Illinois,2020-04-07,1291,73,13553,380,12671821,2020-04-01,1.32983131237673,0.0152945131401038
Illinois,2020-04-08,1525,82,15078,462,12671821,2020-04-02,1.3257594187161,0.0147315695921726
Illinois,2020-04-09,1344,66,16422,528,12671821,2020-04-03,1.33465185718646,0.0142859993600168
Illinois,2020-04-10,1465,69,17887,597,12671821,2020-04-04,1.28182181153263,0.0135236146012608
Illinois,2020-04-11,1293,80,19180,677,12671821,2020-04-05,1.18139028141883,0.0125765245855813
Illinois,2020-04-12,1672,43,20852,720,12671821,2020-04-06,1.22613132523755,0.0125180629414043
Illinois,2020-04-13,1173,78,22025,798,12671821,2020-04-07,1.19466332321107,0.0120901487851491
Illinois,2020-04-14,1223,70,23248,868,12671821,2020-04-08,1.13428829045151,0.0115193280227472
Illinois,2020-04-15,1345,81,24593,949,12671821,2020-04-09,1.07632181529673,0.0110335413293685
Illinois,2020-04-16,1141,123,25734,1072,12671821,2020-04-10,1.031337219505,0.0106870019745154
Illinois,2020-04-17,1844,60,27578,1132,12671821,2020-04-11,1.06223282011634,0.0107897905197747
Illinois,2020-04-18,1582,127,29160,1259,12671821,2020-04-12,1.08250985021168,0.0108353970234125
Illinois,2020-04-19,1197,31,30357,1290,12671821,2020-04-13,1.01398381336362,0.0103999707358677
Illinois,2020-04-20,1156,59,31513,1349,12671821,2020-04-14,1.00269433786705,0.010293387900005
Illinois,2020-04-21,1546,119,33059,1468,12671821,2020-04-15,1.03593331971386,0.0104581058258986
Illinois,2020-04-22,2048,97,35107,1565,12671821,2020-04-16,1.10477098453326,0.0107737680418218
Illinois,2020-04-23,1830,123,36937,1688,12671821,2020-04-17,1.15717099023727,0.0109322860679961
Illinois,2020-04-24,2721,107,39658,1795,12671821,2020-04-18,1.21068071895185,0.0110148397663501
Illinois,2020-04-25,2119,80,41777,1875,12671821,2020-04-19,1.21360024211549,0.0108038959486944
Illinois,2020-04-26,2126,58,43903,1933,12671821,2020-04-20,1.24451811086248,0.0106925097677574
Illinois,2020-04-27,1980,50,45883,1983,12671821,2020-04-21,1.25657170131998,0.0104819909462808
Illinois,2020-04-28,2219,142,48102,2125,12671821,2020-04-22,1.24658202072522,0.0101634041668723
Illinois,2020-04-29,2256,90,50358,2215,12671821,2020-04-23,1.1983120538286,0.00970301113141953
Illinois,2020-04-30,2560,140,52918,2355,12671821,2020-04-24,1.19891532528415,0.00948359389669453
Illinois,2020-05-01,3137,102,56055,2457,12671821,2020-04-25,1.17947685846578,0.00921072854927125
Illinois,2020-05-02,2450,102,58505,2559,12671821,2020-04-26,1.15583965403082,0.00893639998961267
Illinois,2020-05-03,2994,59,61499,2618,12671821,2020-04-27,1.17355266975233,0.00884674010041027
Illinois,2020-05-04,2278,41,63777,2659,12671821,2020-04-28,1.15165873993585,0.00860910404383566
Illinois,2020-05-05,2112,175,65889,2834,12671821,2020-04-29,1.10562457713834,0.00828980135315204
Illinois,2020-05-06,2343,140,68232,2974,12671821,2020-04-30,1.08179670540741,0.00809138058817378
Illinois,2020-05-07,2639,137,70871,3111,12671821,2020-05-01,1.06559290924756,0.00795262879758472
Illinois,2020-05-08,2889,130,73760,3241,12671821,2020-05-02,1.03459485183703,0.0077751733954168
Illinois,2020-05-09,2325,108,76085,3349,12671821,2020-05-03,1.01681659556303,0.00766868393712974
Illinois,2020-05-10,1656,57,77741,3406,12671821,2020-05-04,0.93473629687528,0.00733425465243642
Indiana,2020-03-08,1,0,2,0,6732219,2020-03-02,5.49105697733272,3.17026322399862
Indiana,2020-03-09,1,0,3,0,6732219,2020-03-03,4.76779606296843,2.38389803148422
Indiana,2020-03-10,3,0,6,0,6732219,2020-03-04,5.35421408377026,2.02370270455081
Indiana,2020-03-11,5,0,11,0,6732219,2020-03-05,5.53441284732063,1.59764737360354
Indiana,2020-03-12,2,0,13,0,6732219,2020-03-06,3.6638805007504,0.979213252849267
Indiana,2020-03-13,0,0,13,0,6732219,2020-03-07,2.19770774175058,0.609534457797376
Indiana,2020-03-14,3,0,16,0,6732219,2020-03-08,2.10650809395367,0.526627023488419
Indiana,2020-03-15,4,0,20,0,6732219,2020-03-09,2.08097381901105,0.477408135853845
Indiana,2020-03-16,5,1,25,1,6732219,2020-03-10,2.08535437931992,0.434826446505249
Indiana,2020-03-17,5,1,30,2,6732219,2020-03-11,1.87517848635544,0.375035697271088
Indiana,2020-03-18,8,0,38,2,6732219,2020-03-12,1.772568264386,0.334983914960767
Indiana,2020-03-19,22,0,60,2,6732219,2020-03-13,2.6264939544436,0.379101747905735
Indiana,2020-03-20,26,1,86,3,6732219,2020-03-14,3.20391936091508,0.372448060431984
Indiana,2020-03-21,42,1,128,4,6732219,2020-03-15,3.47998981480782,0.327369904055209
Indiana,2020-03-22,76,2,204,6,6732219,2020-03-16,3.88084733693084,0.285325570822537
Indiana,2020-03-23,66,1,270,7,6732219,2020-03-17,3.36619940941243,0.214621035496893
Indiana,2020-03-24,98,5,368,12,6732219,2020-03-18,3.12051737353493,0.169483239210415
Indiana,2020-03-25,109,2,477,14,6732219,2020-03-19,2.84456420676821,0.135609277693027
Indiana,2020-03-26,168,3,645,17,6732219,2020-03-20,2.74554273963647,0.113417325177689
Indiana,2020-03-27,334,8,979,25,6732219,2020-03-21,3.09826041844758,0.10362132931363
Indiana,2020-03-28,254,6,1233,31,6732219,2020-03-22,2.7487408905283,0.082652546693497
Indiana,2020-03-29,280,1,1513,32,6732219,2020-03-23,2.37342239696993,0.0655751644620724
Indiana,2020-03-30,273,3,1786,35,6732219,2020-03-24,2.11872498835457,0.0543978579125138
Indiana,2020-03-31,372,14,2158,49,6732219,2020-03-25,2.01153131207359,0.047531224680491
Indiana,2020-04-01,406,16,2564,65,6732219,2020-03-26,1.93053223035168,0.0422485501147006
Indiana,2020-04-02,474,13,3038,78,6732219,2020-03-27,1.8467390834917,0.0377436127284391
Indiana,2020-04-03,399,24,3437,102,6732219,2020-03-28,1.60433933465053,0.0323531794904658
Indiana,2020-04-04,516,14,3953,116,6732219,2020-03-29,1.55040216867716,0.0297221414233517
Indiana,2020-04-05,458,11,4411,127,6732219,2020-03-30,1.47615397797307,0.0274162185559094
Indiana,2020-04-06,545,16,4956,143,6732219,2020-03-31,1.45791862875287,0.0258901856266664
Indiana,2020-04-07,554,30,5510,173,6732219,2020-04-01,1.40283970331328,0.0242265332429363
Indiana,2020-04-08,433,30,5943,203,6732219,2020-04-02,1.29616007068869,0.0222946309829296
Indiana,2020-04-09,408,42,6351,245,6732219,2020-04-03,1.18516220354236,0.0205874018046816
Indiana,2020-04-10,556,55,6907,300,6732219,2020-04-04,1.18362007472003,0.0200902349409555
Indiana,2020-04-11,528,30,7435,330,6732219,2020-04-05,1.14287737942099,0.0193652407141305
Indiana,2020-04-12,493,13,7928,343,6732219,2020-04-06,1.11535030993215,0.0188045686049067
Indiana,2020-04-13,431,7,8359,350,6732219,2020-04-07,1.05053756995593,0.018005982047894
Indiana,2020-04-14,168,37,8527,387,6732219,2020-04-08,0.916145710084927,0.0166765010293779
Indiana,2020-04-15,433,49,8960,436,6732219,2020-04-09,0.922633861814453,0.0167946041518453
Indiana,2020-04-16,582,41,9542,477,6732219,2020-04-10,0.995019421532983,0.0176116528518516
Indiana,2020-04-17,612,45,10154,522,6732219,2020-04-11,1.02035216354651,0.0179036706206162
Indiana,2020-04-18,487,23,10641,545,6732219,2020-04-12,1.00454542764793,0.0177386310684398
Indiana,2020-04-19,570,17,11211,562,6732219,2020-04-13,1.02600992526002,0.0179039966442697
Indiana,2020-04-20,477,15,11688,577,6732219,2020-04-14,1.03669635805653,0.0179650924347327
Indiana,2020-04-21,409,58,12097,635,6732219,2020-04-15,1.10359863416462,0.0184678453548282
Indiana,2020-04-22,341,31,12438,666,6732219,2020-04-16,1.05732903632211,0.0179259815283266
Indiana,2020-04-23,601,40,13039,706,6732219,2020-04-17,1.04482291447434,0.0176657787187232
Indiana,2020-04-24,642,35,13681,741,6732219,2020-04-18,1.0429283797968,0.0175586126106242
Indiana,2020-04-25,718,45,14399,786,6732219,2020-04-19,1.10069240247042,0.0179527013342605
Indiana,2020-04-26,613,27,15012,813,6732219,2020-04-20,1.09471624541405,0.0177539710235502
Indiana,2020-04-27,949,31,15961,844,6732219,2020-04-21,1.20410963887741,0.0184182674068913
Indiana,2020-04-28,627,57,16588,901,6732219,2020-04-22,1.22281147793294,0.0182448220893804
Indiana,2020-04-29,594,63,17182,964,6732219,2020-04-23,1.23217389324601,0.0178876749556996
Indiana,2020-04-30,653,150,17835,1114,6732219,2020-04-24,1.1865024027149,0.0171310413271925
Indiana,2020-05-01,795,61,18630,1175,6732219,2020-04-25,1.17187098099049,0.0166562488415684
Indiana,2020-05-02,665,-60,19295,1115,6732219,2020-04-26,1.11647355092591,0.0159545069366051
Indiana,2020-05-03,638,17,19933,1132,6732219,2020-04-27,1.08913855642187,0.0155243107713606
Indiana,2020-05-04,574,19,20507,1151,6732219,2020-04-28,0.985025703107538,0.0146078091417658
Indiana,2020-05-05,526,60,21033,1211,6732219,2020-04-29,0.957544186924732,0.0143606499099957
Indiana,2020-05-06,837,166,21870,1377,6732219,2020-04-30,1.0180438909162,0.0148671042158642
Indiana,2020-05-07,633,37,22503,1414,6732219,2020-05-01,1.01553256518058,0.0148621594910737
Indiana,2020-05-08,643,33,23146,1447,6732219,2020-05-02,0.978234238194709,0.0145551878144077
Indiana,2020-05-09,586,43,23732,1490,6732219,2020-05-03,0.962623653704361,0.014449834736102
Indiana,2020-05-10,394,18,24126,1508,6732219,2020-05-04,0.916392178575435,0.0141503493080515
Iowa,2020-03-08,0,0,0,0,3155070,2020-03-02,5,5
Iowa,2020-03-09,3,0,3,0,3155070,2020-03-03,20,10
Iowa,2020-03-10,5,0,8,0,3155070,2020-03-04,15.2410221003549,5.08034070011831
Iowa,2020-03-11,5,0,13,0,3155070,2020-03-05,7.40787252534886,1.97983721105366
Iowa,2020-03-12,1,0,14,0,3155070,2020-03-06,3.65057500745588,0.942574413863843
Iowa,2020-03-13,3,0,17,0,3155070,2020-03-07,2.76989270174555,0.652869970854469
Iowa,2020-03-14,0,0,17,0,3155070,2020-03-08,2.04476464016296,0.481955647663234
Iowa,2020-03-15,1,0,18,0,3155070,2020-03-09,1.74474844974145,0.40027274601696
Iowa,2020-03-16,5,0,23,0,3155070,2020-03-10,1.66822698572636,0.364036973259956
Iowa,2020-03-17,0,0,23,0,3155070,2020-03-11,1.12334211733483,0.280835529333706
Iowa,2020-03-18,15,0,38,0,3155070,2020-03-12,1.72496649842204,0.338293762913377
Iowa,2020-03-19,6,0,44,0,3155070,2020-03-13,1.88954285253444,0.339371914721981
Iowa,2020-03-20,1,0,45,0,3155070,2020-03-14,1.50708656027092,0.279858948471598
Iowa,2020-03-21,24,0,69,0,3155070,2020-03-15,2.44180104315176,0.335407168337822
Iowa,2020-03-22,21,0,90,0,3155070,2020-03-16,2.76060638578293,0.323104538348998
Iowa,2020-03-23,15,0,105,0,3155070,2020-03-17,2.34146056776951,0.257008686516261
Iowa,2020-03-24,19,0,124,0,3155070,2020-03-18,2.22302708648825,0.220112480765693
Iowa,2020-03-25,22,1,146,1,3155070,2020-03-19,1.89954621520223,0.181943529491305
Iowa,2020-03-26,33,0,179,1,3155070,2020-03-20,1.96579924916184,0.168565894952731
Iowa,2020-03-27,56,2,235,3,3155070,2020-03-21,2.31812273284506,0.167733474143776
Iowa,2020-03-28,63,0,298,3,3155070,2020-03-22,2.24003292875326,0.147703397298348
Iowa,2020-03-29,38,1,336,4,3155070,2020-03-23,1.90726005868849,0.121356051437578
Iowa,2020-03-30,88,2,424,6,3155070,2020-03-24,2.04480051952975,0.114307824052385
Iowa,2020-03-31,73,1,497,7,3155070,2020-03-25,1.98628940645789,0.102708580084689
Iowa,2020-04-01,50,2,547,9,3155070,2020-03-26,1.76428836211564,0.0879947056398196
Iowa,2020-04-02,67,2,614,11,3155070,2020-03-27,1.62917272772868,0.0780232230891987
Iowa,2020-04-03,85,0,699,11,3155070,2020-03-28,1.52337232720728,0.07064470008507
Iowa,2020-04-04,88,3,787,14,3155070,2020-03-29,1.43562048173515,0.0648547225410174
Iowa,2020-04-05,82,4,869,18,3155070,2020-03-30,1.42358392759367,0.0616045014969467
Iowa,2020-04-06,77,7,946,25,3155070,2020-03-31,1.27813123026289,0.0558887764940218
Iowa,2020-04-07,100,0,1046,25,3155070,2020-04-01,1.25405202341544,0.053472957947875
Iowa,2020-04-08,99,2,1145,27,3155070,2020-04-02,1.29408645583224,0.05287493915456
Iowa,2020-04-09,125,2,1270,29,3155070,2020-04-03,1.33888471845308,0.0522348678037055
Iowa,2020-04-10,118,2,1388,31,3155070,2020-04-04,1.31435760660029,0.0500367389376936
Iowa,2020-04-11,122,3,1510,34,3155070,2020-04-05,1.28853083875334,0.0478878714852154
Iowa,2020-04-12,77,7,1587,41,3155070,2020-04-06,1.20244594013066,0.0448436666123414
Iowa,2020-04-13,123,0,1710,41,3155070,2020-04-07,1.21732899264527,0.0440126226150769
Iowa,2020-04-14,189,8,1899,49,3155070,2020-04-08,1.30039410229957,0.0444985701069575
Iowa,2020-04-15,96,4,1995,53,3155070,2020-04-09,1.22442626444886,0.0419727917728081
Iowa,2020-04-16,146,7,2141,60,3155070,2020-04-10,1.18810744567491,0.0402343949815043
Iowa,2020-04-17,191,4,2332,64,3155070,2020-04-11,1.23437906771057,0.0401543540741628
Iowa,2020-04-18,181,10,2513,74,3155070,2020-04-12,1.25292997065194,0.03954211924745
Iowa,2020-04-19,389,1,2902,75,3155070,2020-04-13,1.55829956553168,0.042955918027305
Iowa,2020-04-20,257,4,3159,79,3155070,2020-04-14,1.5683110628951,0.0411858662566391
Iowa,2020-04-21,482,4,3641,83,3155070,2020-04-15,1.67743433530401,0.0401787882519019
Iowa,2020-04-22,107,7,3748,90,3155070,2020-04-16,1.48751312153747,0.0355177961941833
Iowa,2020-04-23,176,6,3924,96,3155070,2020-04-17,1.35099109839204,0.0319856412917144
Iowa,2020-04-24,521,11,4445,107,3155070,2020-04-18,1.47630859988873,0.0321088431137708
Iowa,2020-04-25,647,5,5092,112,3155070,2020-04-19,1.65151727776176,0.0325142146537874
Iowa,2020-04-26,384,6,5476,118,3155070,2020-04-20,1.46323832986116,0.0288354313468885
Iowa,2020-04-27,392,9,5868,127,3155070,2020-04-21,1.38069110302717,0.0265223426106481
Iowa,2020-04-28,508,9,6376,136,3155070,2020-04-22,1.28311630805849,0.0245305891212103
Iowa,2020-04-29,467,12,6843,148,3155070,2020-04-23,1.3584526068344,0.0244142853100657
Iowa,2020-04-30,302,14,7145,162,3155070,2020-04-24,1.32087869959791,0.0232702028325281
Iowa,2020-05-01,739,8,7884,170,3155070,2020-04-25,1.31363066266046,0.0223972169022321
Iowa,2020-05-02,759,5,8643,175,3155070,2020-04-26,1.27001858539083,0.0213095165954852
Iowa,2020-05-03,532,9,9175,184,3155070,2020-04-27,1.2453563361865,0.020473532050337
Iowa,2020-05-04,528,4,9703,188,3155070,2020-04-28,1.22380508929745,0.0197593637244256
Iowa,2020-05-05,408,19,10111,207,3155070,2020-04-29,1.13468853326862,0.018564071493341
Iowa,2020-05-06,293,12,10404,219,3155070,2020-04-30,1.04323436470291,0.0174797383281477
Iowa,2020-05-07,655,12,11059,231,3155070,2020-05-01,1.12776677884557,0.0180240927696945
Iowa,2020-05-08,398,12,11457,243,3155070,2020-05-02,1.00968596558048,0.0168891987175608
Iowa,2020-05-09,214,9,11671,252,3155070,2020-05-03,0.844110097827022,0.0153373192977085
Iowa,2020-05-10,288,13,11959,265,3155070,2020-05-04,0.792617335861046,0.0150193440930861
Kansas,2020-03-08,1,0,1,0,2913314,2020-03-02,10,7.07106781186548
Kansas,2020-03-09,0,0,1,0,2913314,2020-03-03,6.05747589181412,4.2832822799758
Kansas,2020-03-10,0,0,1,0,2913314,2020-03-04,3.66070465155515,2.58850908303578
Kansas,2020-03-11,0,0,1,0,2913314,2020-03-05,2.82170413630682,1.99524612928469
Kansas,2020-03-12,3,0,4,0,2913314,2020-03-06,6.01780313548842,2.6912433772327
Kansas,2020-03-13,2,1,6,1,2913314,2020-03-07,5.33082630480674,2.01486295500001
Kansas,2020-03-14,2,0,8,1,2913314,2020-03-08,3.9285626324596,1.30952087748653
Kansas,2020-03-15,0,0,8,1,2913314,2020-03-09,2.27095189712009,0.802902743101036
Kansas,2020-03-16,3,0,11,1,2913314,2020-03-10,2.41493729351966,0.728130990440099
Kansas,2020-03-17,7,0,18,1,2913314,2020-03-11,3.21265535744788,0.757230129622229
Kansas,2020-03-18,4,0,22,1,2913314,2020-03-12,2.87336289946017,0.612603028514543
Kansas,2020-03-19,13,0,35,1,2913314,2020-03-13,3.03346751292199,0.536246362224058
Kansas,2020-03-20,13,0,48,1,2913314,2020-03-14,2.96598596504818,0.452308619296418
Kansas,2020-03-21,9,1,57,2,2913314,2020-03-15,2.48997994782189,0.352136341224678
Kansas,2020-03-22,8,0,65,2,2913314,2020-03-16,2.18959813970146,0.287508321120483
Kansas,2020-03-23,19,0,84,2,2913314,2020-03-17,2.23063080192092,0.259305563632539
Kansas,2020-03-24,16,0,100,2,2913314,2020-03-18,2.01319052249923,0.220976367920387
Kansas,2020-03-25,34,1,134,3,2913314,2020-03-19,2.2444963509825,0.211144455638007
Kansas,2020-03-26,38,0,172,3,2913314,2020-03-20,2.21982420802788,0.18896398542201
Kansas,2020-03-27,34,1,206,4,2913314,2020-03-21,2.04224063828844,0.161960217661268
Kansas,2020-03-28,60,0,266,4,2913314,2020-03-22,2.20269724074862,0.152000550349906
Kansas,2020-03-29,64,3,330,7,2913314,2020-03-23,2.26192254372511,0.138687369442577
Kansas,2020-03-30,42,1,372,8,2913314,2020-03-24,1.95728467096474,0.11513439240969
Kansas,2020-03-31,62,1,434,9,2913314,2020-03-25,1.86255539340381,0.101762271891846
Kansas,2020-04-01,51,1,485,10,2913314,2020-03-26,1.65434437223885,0.088176851315049
Kansas,2020-04-02,68,2,553,12,2913314,2020-03-27,1.55814480646261,0.0797216236162201
Kansas,2020-04-03,76,6,629,18,2913314,2020-03-28,1.53946151364672,0.0747628601924089
Kansas,2020-04-04,69,3,698,21,2913314,2020-03-29,1.40961243857394,0.0677416507043047
Kansas,2020-04-05,53,1,751,22,2913314,2020-03-30,1.25154735324947,0.060924371916549
Kansas,2020-04-06,98,3,849,25,2913314,2020-03-31,1.3301250371693,0.0608385031152702
Kansas,2020-04-07,63,4,912,29,2913314,2020-04-01,1.25385536282012,0.057290113821643
Kansas,2020-04-08,134,5,1046,34,2913314,2020-04-02,1.38489866365159,0.0584184242585677
Kansas,2020-04-09,70,8,1116,42,2913314,2020-04-03,1.29774026042711,0.0546447226682029
Kansas,2020-04-10,1,0,1117,42,2913314,2020-04-04,1.04862596132216,0.0474205051459837
Kansas,2020-04-11,158,13,1275,55,2913314,2020-04-05,1.2025695328854,0.0500202983265648
Kansas,2020-04-12,69,1,1344,56,2913314,2020-04-06,1.20218063155768,0.0493260687883035
Kansas,2020-04-13,46,6,1390,62,2913314,2020-04-07,1.04868742396209,0.045044981888265
Kansas,2020-04-14,51,7,1441,69,2913314,2020-04-08,1.00180373634997,0.0435155735766757
Kansas,2020-04-15,63,2,1504,71,2913314,2020-04-09,0.865214469568046,0.0403847530049664
Kansas,2020-04-16,111,9,1615,80,2913314,2020-04-10,0.959807029608668,0.0429238752697427
Kansas,2020-04-17,115,2,1730,82,2913314,2020-04-11,1.20231092066974,0.04852131990455
Kansas,2020-04-18,91,3,1821,85,2913314,2020-04-12,1.04655182825742,0.0447473249275298
Kansas,2020-04-19,84,8,1905,93,2913314,2020-04-13,1.04763487250716,0.0441918098821929
Kansas,2020-04-20,143,9,2048,102,2913314,2020-04-14,1.21851330956901,0.0474665393781922
Kansas,2020-04-21,116,7,2164,109,2913314,2020-04-15,1.29629771692731,0.0481765252392818
Kansas,2020-04-22,167,3,2331,112,2913314,2020-04-16,1.39924173456421,0.048627011734477
Kansas,2020-04-23,390,1,2721,113,2913314,2020-04-17,1.7352311616267,0.0521535082522496
Kansas,2020-04-24,238,5,2959,118,2913314,2020-04-18,1.70524372051917,0.0486221213863169
Kansas,2020-04-25,176,2,3135,120,2913314,2020-04-19,1.57868686812506,0.043534455805421
Kansas,2020-04-26,142,1,3277,121,2913314,2020-04-20,1.45675276968705,0.0393143033039627
Kansas,2020-04-27,196,5,3473,126,2913314,2020-04-21,1.36795597982514,0.0362253307531659
Kansas,2020-04-28,179,1,3652,127,2913314,2020-04-22,1.31620205027071,0.0341094890690443
Kansas,2020-04-29,187,7,3839,134,2913314,2020-04-23,1.24450477524931,0.0320370078375792
Kansas,2020-04-30,574,0,4413,134,2913314,2020-04-24,1.31890145866908,0.0320541208171149
Kansas,2020-05-01,221,6,4634,140,2913314,2020-04-25,1.22927733121813,0.0300270637377431
Kansas,2020-05-02,251,2,4885,142,2913314,2020-04-26,1.21352547149529,0.0290005225535137
Kansas,2020-05-03,271,2,5156,144,2913314,2020-04-27,1.24470573730499,0.0287069971869114
Kansas,2020-05-04,227,12,5383,156,2913314,2020-04-28,1.20432148944108,0.0275493966702846
Kansas,2020-05-05,265,5,5648,161,2913314,2020-04-29,1.20048632168499,0.0268638456588358
Kansas,2020-05-06,345,3,5993,164,2913314,2020-04-30,1.24135974329744,0.0267407768628635
Kansas,2020-05-07,339,1,6332,165,2913314,2020-05-01,1.05423128242258,0.0240594272587687
Kansas,2020-05-08,335,3,6667,168,2913314,2020-05-02,1.08573099811458,0.0240739172298571
Kansas,2020-05-09,162,6,6829,174,2913314,2020-05-03,1.02389118202238,0.0232163530769127
Kansas,2020-05-10,122,0,6951,174,2913314,2020-05-04,0.934818077373866,0.0220583963502834
Kentucky,2020-03-08,0,0,1,0,4467673,2020-03-02,3.66070465155515,2.58850908303578
Kentucky,2020-03-09,3,0,4,0,4467673,2020-03-03,7.05426034076706,3.1547611305872
Kentucky,2020-03-10,1,0,5,0,4467673,2020-03-04,4.91247778899266,2.00551065929795
Kentucky,2020-03-11,3,0,8,0,4467673,2020-03-05,4.30250448891128,1.43416816297043
Kentucky,2020-03-12,2,0,10,0,4467673,2020-03-06,3.37965141287956,1.01900324170145
Kentucky,2020-03-13,4,0,14,0,4467673,2020-03-07,2.95102417510864,0.788694385953122
Kentucky,2020-03-14,2,0,16,0,4467673,2020-03-08,2.46512678291858,0.616281695729644
Kentucky,2020-03-15,2,0,18,0,4467673,2020-03-09,2.13819054288158,0.503976344113503
Kentucky,2020-03-16,3,1,21,1,4467673,2020-03-10,1.73676905155564,0.409360391236641
Kentucky,2020-03-17,5,0,26,1,4467673,2020-03-11,1.82376532119472,0.388828072943234
Kentucky,2020-03-18,2,0,28,1,4467673,2020-03-12,1.51511764428767,0.330625775795781
Kentucky,2020-03-19,22,1,50,2,4467673,2020-03-13,2.635940772252,0.411664786518153
Kentucky,2020-03-20,14,0,64,2,4467673,2020-03-14,2.64081613890688,0.369788224489105
Kentucky,2020-03-21,23,1,87,3,4467673,2020-03-15,2.7901562378746,0.328823066061846
Kentucky,2020-03-22,16,0,103,3,4467673,2020-03-16,2.48545593551316,0.268013606201331
Kentucky,2020-03-23,20,1,123,4,4467673,2020-03-17,2.26277677670983,0.222958020804243
Kentucky,2020-03-24,39,0,162,4,4467673,2020-03-18,2.37873037411612,0.203228651076956
Kentucky,2020-03-25,35,1,197,5,4467673,2020-03-19,2.32541555959772,0.178351231873236
Kentucky,2020-03-26,50,0,247,5,4467673,2020-03-20,2.12717206499618,0.151171536022943
Kentucky,2020-03-27,54,2,301,7,4467673,2020-03-21,2.05805227807638,0.133403714991412
Kentucky,2020-03-28,79,2,380,9,4467673,2020-03-22,2.0833506269738,0.121503475985553
Kentucky,2020-03-29,58,0,438,9,4467673,2020-03-23,1.95023724917231,0.106394164493507
Kentucky,2020-03-30,41,2,479,11,4467673,2020-03-24,1.71796842921837,0.0909245312045369
Kentucky,2020-03-31,149,0,628,11,4467673,2020-03-25,1.92817392267402,0.0892252482017269
Kentucky,2020-04-01,4,7,632,18,4467673,2020-03-26,1.53063609380362,0.0733041741876666
Kentucky,2020-04-02,138,13,770,31,4467673,2020-03-27,1.60793669581674,0.0702430406994616
Kentucky,2020-04-03,0,3,770,34,4467673,2020-03-28,1.28941593309556,0.0594763219205171
Kentucky,2020-04-04,147,6,917,40,4467673,2020-03-29,1.35545071164767,0.0584376296961951
Kentucky,2020-04-05,38,5,955,45,4467673,2020-03-30,1.22247147142458,0.0537123127901267
Kentucky,2020-04-06,0,0,955,45,4467673,2020-03-31,1.06158579466087,0.0486066744781782
Kentucky,2020-04-07,194,20,1149,65,4467673,2020-04-01,1.13266849649365,0.0495755532957222
Kentucky,2020-04-08,0,0,1149,65,4467673,2020-04-02,1.10088869538981,0.048370272301721
Kentucky,2020-04-09,192,8,1341,73,4467673,2020-04-03,1.18524369993222,0.0495575286989779
Kentucky,2020-04-10,352,17,1693,90,4467673,2020-04-04,1.85456897376745,0.0610108399855047
Kentucky,2020-04-11,0,0,1693,90,4467673,2020-04-05,1.38210987714161,0.0495829156508896
Kentucky,2020-04-12,270,7,1963,97,4467673,2020-04-06,1.59457730158625,0.0501995697146722
Kentucky,2020-04-13,55,16,2018,113,4467673,2020-04-07,1.52301370954712,0.0466909809949134
Kentucky,2020-04-14,30,-7,2048,106,4467673,2020-04-08,1.14984649939153,0.0383282166463842
Kentucky,2020-04-15,162,9,2210,115,4467673,2020-04-09,1.27786677440049,0.0392123905856232
Kentucky,2020-04-16,225,14,2435,129,4467673,2020-04-10,1.25993653523403,0.0380751488700596
Kentucky,2020-04-17,87,8,2522,137,4467673,2020-04-11,0.901066803328327,0.0312764853366302
Kentucky,2020-04-18,185,7,2707,144,4467673,2020-04-12,1.09181236797798,0.0342700697642274
Kentucky,2020-04-19,253,2,2960,146,4467673,2020-04-13,1.0745450867765,0.0340141303820459
Kentucky,2020-04-20,90,8,3050,154,4467673,2020-04-14,1.08990994053769,0.033910988753799
Kentucky,2020-04-21,154,17,3204,171,4467673,2020-04-15,1.19943416238256,0.0352622268329579
Kentucky,2020-04-22,174,14,3378,185,4467673,2020-04-16,1.17186233359583,0.0342743588664514
Kentucky,2020-04-23,101,6,3479,191,4467673,2020-04-17,1.00621467894067,0.0311266586785905
Kentucky,2020-04-24,300,9,3779,200,4467673,2020-04-18,1.19283919540618,0.0336311393541545
Kentucky,2020-04-25,136,5,3915,205,4467673,2020-04-19,1.11969149215681,0.0322021766343574
Kentucky,2020-04-26,170,3,4085,208,4467673,2020-04-20,1.00762357778019,0.0300281879784131
Kentucky,2020-04-27,71,5,4156,213,4467673,2020-04-21,0.980320594365989,0.0294641770726314
Kentucky,2020-04-28,219,12,4375,225,4467673,2020-04-22,1.04108416406474,0.0304103931379962
Kentucky,2020-04-29,162,9,4537,234,4467673,2020-04-23,1.02713758962374,0.0301577980425328
Kentucky,2020-04-30,171,6,4708,240,4467673,2020-04-24,1.08066295727488,0.0308132643176179
Kentucky,2020-05-01,174,6,4882,246,4467673,2020-04-25,0.9578979904138,0.0288293416862773
Kentucky,2020-05-02,-3,2,4879,248,4467673,2020-04-26,0.837966163309654,0.0269332525673241
Kentucky,2020-05-03,251,5,5130,253,4467673,2020-04-27,0.932811742971966,0.0288009133525201
Kentucky,2020-05-04,115,8,5245,261,4467673,2020-04-28,0.997268192329321,0.0301648997659231
Kentucky,2020-05-05,577,14,5822,275,4467673,2020-04-29,1.33138364368723,0.0349517971375036
Kentucky,2020-05-06,112,8,5934,283,4467673,2020-04-30,1.2321571386535,0.0329190300130247
Kentucky,2020-05-07,195,11,6129,294,4467673,2020-05-01,1.17929256142132,0.031240223120973
Kentucky,2020-05-08,159,4,6288,298,4467673,2020-05-02,1.11979918005405,0.0298215758397704
Kentucky,2020-05-09,152,6,6440,304,4467673,2020-05-03,1.20318647717648,0.0304433490679232
Kentucky,2020-05-10,0,0,6440,304,4467673,2020-05-04,0.974296336626354,0.0269085145497384
Louisiana,2020-03-08,0,0,0,0,4648794,2020-03-02,5,5
Louisiana,2020-03-09,0,0,0,0,4648794,2020-03-03,5,5
Louisiana,2020-03-10,0,0,0,0,4648794,2020-03-04,5,5
Louisiana,2020-03-11,5,0,5,0,4648794,2020-03-05,30,12.2474487139159
Louisiana,2020-03-12,14,0,19,0,4648794,2020-03-06,23.5058332343588,5.25606409797999
Louisiana,2020-03-13,10,0,29,0,4648794,2020-03-07,7.99125891165961,1.45899758959338
Louisiana,2020-03-14,48,1,77,1,4648794,2020-03-08,8.76950022373805,0.992950370426449
Louisiana,2020-03-15,10,1,87,2,4648794,2020-03-09,4.35880155294991,0.464649806770434
Louisiana,2020-03-16,28,1,115,3,4648794,2020-03-10,3.25301197131587,0.302034579053749
Louisiana,2020-03-17,81,1,196,4,4648794,2020-03-11,3.78024103940343,0.269331022300723
Louisiana,2020-03-18,61,2,257,6,4648794,2020-03-12,3.22970103620288,0.203049564455317
Louisiana,2020-03-19,135,4,392,10,4648794,2020-03-13,3.25452291714807,0.168287373726395
Louisiana,2020-03-20,145,4,537,14,4648794,2020-03-14,3.08886261969242,0.136911428522189
Louisiana,2020-03-21,226,6,763,20,4648794,2020-03-15,2.93396262120611,0.111937655908276
Louisiana,2020-03-22,74,0,837,20,4648794,2020-03-16,2.3077071374046,0.0842094294325981
Louisiana,2020-03-23,335,15,1172,35,4648794,2020-03-17,2.49869288607918,0.0768192471238771
Louisiana,2020-03-24,216,11,1388,46,4648794,2020-03-18,2.19061613577117,0.0634228947842756
Louisiana,2020-03-25,407,19,1795,65,4648794,2020-03-19,2.23184995233512,0.0568912771893266
Louisiana,2020-03-26,509,18,2304,83,4648794,2020-03-20,2.2256651764595,0.0508864724434074
Louisiana,2020-03-27,440,36,2744,119,4648794,2020-03-21,2.05038694588196,0.0436351319566125
Louisiana,2020-03-28,571,18,3315,137,4648794,2020-03-22,1.92989673456603,0.0381951890446036
Louisiana,2020-03-29,225,14,3540,151,4648794,2020-03-23,1.70324920729728,0.0327547924480247
Louisiana,2020-03-30,485,34,4025,185,4648794,2020-03-24,1.54525350367512,0.0289249590370999
Louisiana,2020-03-31,1212,54,5237,239,4648794,2020-03-25,1.85161116117857,0.0298414158824678
Louisiana,2020-04-01,1187,34,6424,273,4648794,2020-03-26,1.92815502053915,0.028336842220819
Louisiana,2020-04-02,2725,37,9149,310,4648794,2020-03-27,2.39150010629718,0.0289036012483074
Louisiana,2020-04-03,1148,60,10297,370,4648794,2020-03-28,2.10410387094924,0.0242091022704972
Louisiana,2020-04-04,2199,39,12496,409,4648794,2020-03-29,2.04442095982028,0.0213354437748748
Louisiana,2020-04-05,514,68,13010,477,4648794,2020-03-30,1.73330440749757,0.0178105332726058
Louisiana,2020-04-06,1857,35,14867,512,4648794,2020-03-31,1.68748848830444,0.0162056363771457
Louisiana,2020-04-07,1417,70,16284,582,4648794,2020-04-01,1.5009258373122,0.0142796446766684
Louisiana,2020-04-08,746,70,17030,652,4648794,2020-04-02,1.28527875588781,0.012479610901646
Louisiana,2020-04-09,1253,50,18283,702,4648794,2020-04-03,1.02758450596712,0.0107513567168904
Louisiana,2020-04-10,970,53,19253,755,4648794,2020-04-04,0.981617204941845,0.0103719609886575
Louisiana,2020-04-11,761,51,20014,806,4648794,2020-04-05,0.825908022882408,0.00952470738865035
Louisiana,2020-04-12,581,34,20595,840,4648794,2020-04-06,0.854277115383343,0.00980826866358824
Louisiana,2020-04-13,421,44,21016,884,4648794,2020-04-07,0.719272999044393,0.00917183429051867
Louisiana,2020-04-14,502,129,21518,1013,4648794,2020-04-08,0.644424605585465,0.00890663738725445
Louisiana,2020-04-15,433,90,21951,1103,4648794,2020-04-09,0.655065269787306,0.00933713783589927
Louisiana,2020-04-16,581,53,22532,1156,4648794,2020-04-10,0.615363185555487,0.00943924037493293
Louisiana,2020-04-17,586,57,23118,1213,4648794,2020-04-11,0.611164794162862,0.00982940894947135
Louisiana,2020-04-18,462,54,23580,1267,4648794,2020-04-12,0.619313667500337,0.0103695308930891
Louisiana,2020-04-19,348,29,23928,1296,4648794,2020-04-13,0.635062278582257,0.0109985015295833
Louisiana,2020-04-20,595,32,24523,1328,4648794,2020-04-14,0.730663353210938,0.0123363741686864
Louisiana,2020-04-21,331,77,24854,1405,4648794,2020-04-15,0.748381508082658,0.0129552245393459
Louisiana,2020-04-22,404,68,25258,1473,4648794,2020-04-16,0.787588360551998,0.013693565352632
Louisiana,2020-04-23,481,126,25739,1599,4648794,2020-04-17,0.805691250947831,0.0142249735596382
Louisiana,2020-04-24,401,61,26140,1660,4648794,2020-04-18,0.795309712993085,0.0144649591952092
Louisiana,2020-04-25,372,47,26512,1707,4648794,2020-04-19,0.808128807221459,0.0149219148277933
Louisiana,2020-04-26,261,22,26773,1729,4648794,2020-04-20,0.820939302942723,0.0153884047383788
Louisiana,2020-04-27,295,11,27068,1740,4648794,2020-04-21,0.766270773657199,0.0151863380037564
Louisiana,2020-04-28,218,61,27286,1801,4648794,2020-04-22,0.768746356930468,0.0155851869517088
Louisiana,2020-04-29,374,44,27660,1845,4648794,2020-04-23,0.802022315354266,0.0163609895329145
Louisiana,2020-04-30,341,60,28001,1905,4648794,2020-04-24,0.793447649664854,0.0166792301371112
Louisiana,2020-05-01,710,65,28711,1970,4648794,2020-04-25,0.944868017300676,0.0186309785890943
Louisiana,2020-05-02,429,23,29140,1993,4648794,2020-04-26,0.992822136294966,0.0193631566393218
Louisiana,2020-05-03,200,19,29340,2012,4648794,2020-04-27,0.974078267019141,0.0192219013508464
Louisiana,2020-05-04,333,52,29673,2064,4648794,2020-04-28,0.992241982414725,0.0194370518277669
Louisiana,2020-05-05,323,51,29996,2115,4648794,2020-04-29,1.03607121498247,0.0198987066277557
Louisiana,2020-05-06,403,52,30399,2167,4648794,2020-04-30,1.04283764120706,0.0199223890661128
Louisiana,2020-05-07,253,41,30652,2208,4648794,2020-05-01,1.00008013859444,0.0194199470970711
Louisiana,2020-05-08,203,19,30855,2227,4648794,2020-05-02,0.805768028806756,0.0173978820918154
Louisiana,2020-05-09,562,40,31417,2267,4648794,2020-05-03,0.87839648042945,0.0184040636715709
Louisiana,2020-05-10,183,19,31600,2286,4648794,2020-05-04,0.904744643197988,0.0190272375055392
Maine,2020-03-08,0,0,0,0,1344212,2020-03-02,5,5
Maine,2020-03-09,0,0,0,0,1344212,2020-03-03,5,5
Maine,2020-03-10,0,0,0,0,1344212,2020-03-04,5,5
Maine,2020-03-11,0,0,0,0,1344212,2020-03-05,5,5
Maine,2020-03-12,1,0,1,0,1344212,2020-03-06,10,7.07106781186548
Maine,2020-03-13,2,0,3,0,1344212,2020-03-07,12.1149517836282,6.05747589181412
Maine,2020-03-14,0,0,3,0,1344212,2020-03-08,4.95857142832992,2.47928571416496
Maine,2020-03-15,-1,0,2,0,1344212,2020-03-09,2.85413106516307,1.42706553258154
Maine,2020-03-16,15,0,17,0,1344212,2020-03-10,10.2788764320875,2.35813598003219
Maine,2020-03-17,9,0,26,0,1344212,2020-03-11,6.76835385924693,1.27909864977512
Maine,2020-03-18,9,0,35,0,1344212,2020-03-12,4.20290533300787,0.690953380486779
Maine,2020-03-19,17,0,52,0,1344212,2020-03-13,3.6433796319945,0.500456680929932
Maine,2020-03-20,4,0,56,0,1344212,2020-03-14,2.49875739520719,0.336932378435539
Maine,2020-03-21,14,0,70,0,1344212,2020-03-15,2.31746221430127,0.278989665662695
Maine,2020-03-22,19,0,89,0,1344212,2020-03-16,2.33627714264853,0.249047980208952
Maine,2020-03-23,18,0,107,0,1344212,2020-03-17,1.90662936291277,0.199869065039023
Maine,2020-03-24,11,0,118,0,1344212,2020-03-18,1.60543139706434,0.16647548079593
Maine,2020-03-25,24,0,142,0,1344212,2020-03-19,1.63119983424544,0.156962277233946
Maine,2020-03-26,13,0,155,0,1344212,2020-03-20,1.39371214232625,0.136664719424091
Maine,2020-03-27,13,1,168,1,1344212,2020-03-21,1.37474880185452,0.129325488668989
Maine,2020-03-28,43,0,211,1,1344212,2020-03-22,1.60292349919879,0.134514351930332
Maine,2020-03-29,42,2,253,3,1344212,2020-03-23,1.67971135106963,0.130765351330383
Maine,2020-03-30,22,0,275,3,1344212,2020-03-24,1.5102255181525,0.116171193704038
Maine,2020-03-31,28,2,303,5,1344212,2020-03-25,1.483001832304,0.108738970139381
Maine,2020-04-01,0,0,303,5,1344212,2020-03-26,1.17165744763348,0.0920541029388171
Maine,2020-04-02,73,2,376,7,1344212,2020-03-27,1.5122015987878,0.101492325973076
Maine,2020-04-03,56,2,432,9,1344212,2020-03-28,1.67516539968026,0.102904592491278
Maine,2020-04-04,24,1,456,10,1344212,2020-03-29,1.37086109044968,0.0874029108115329
Maine,2020-04-05,14,0,470,10,1344212,2020-03-30,1.10079606394698,0.0745553170164152
Maine,2020-04-06,29,0,499,10,1344212,2020-03-31,1.09162663746443,0.0727751091642956
Maine,2020-04-07,20,2,519,12,1344212,2020-04-01,1.03441386204575,0.0702205885097542
Maine,2020-04-08,18,2,537,14,1344212,2020-04-02,1.10680523205719,0.0722000124273332
Maine,2020-04-09,23,2,560,16,1344212,2020-04-03,0.857953303315057,0.0630779813670914
Maine,2020-04-10,26,1,586,17,1344212,2020-04-04,0.725193262555749,0.0582489245674642
Maine,2020-04-11,30,2,616,19,1344212,2020-04-05,0.795098582669275,0.0626625466987616
Maine,2020-04-12,17,0,633,19,1344212,2020-04-06,0.857425227019022,0.0669536616208763
Maine,2020-04-13,65,0,698,19,1344212,2020-04-07,1.08731608242447,0.0768848575175532
Maine,2020-04-14,37,1,735,20,1344212,2020-04-08,1.18274731179231,0.0802901192063804
Maine,2020-04-15,35,4,770,24,1344212,2020-04-09,1.23422265678091,0.0806836591159511
Maine,2020-04-16,26,3,796,27,1344212,2020-04-10,1.19444593458644,0.077587600978041
Maine,2020-04-17,31,2,827,29,1344212,2020-04-11,1.16652986684245,0.0749873799364486
Maine,2020-04-18,20,3,847,32,1344212,2020-04-12,1.07782622027332,0.0707627581133835
Maine,2020-04-19,20,2,867,34,1344212,2020-04-13,1.06626255006226,0.0695552994651166
Maine,2020-04-20,8,1,875,35,1344212,2020-04-14,0.796521972631134,0.0597018459468529
Maine,2020-04-21,13,1,888,36,1344212,2020-04-15,0.704102698812842,0.0567382123735634
Maine,2020-04-22,19,3,907,39,1344212,2020-04-16,0.672266248326194,0.0572271034296355
Maine,2020-04-23,30,5,937,44,1344212,2020-04-17,0.746382168082981,0.0626350001620304
Maine,2020-04-24,28,3,965,47,1344212,2020-04-18,0.782713406450853,0.0663888846463713
Maine,2020-04-25,0,0,965,47,1344212,2020-04-19,0.707685649198238,0.0648734370988459
Maine,2020-04-26,50,3,1015,50,1344212,2020-04-20,0.942404792095967,0.0772048087735126
Maine,2020-04-27,8,1,1023,51,1344212,2020-04-21,0.979659335846338,0.0802568199159803
Maine,2020-04-28,17,0,1040,51,1344212,2020-04-22,1.01240013447642,0.0818476998007021
Maine,2020-04-29,16,1,1056,52,1344212,2020-04-23,0.99390723279375,0.0811521857335434
Maine,2020-04-30,39,1,1095,53,1344212,2020-04-24,1.054046500196,0.0835913248401097
Maine,2020-05-01,28,2,1123,55,1344212,2020-04-25,1.04874767611696,0.0831711007562776
Maine,2020-05-02,30,1,1153,56,1344212,2020-04-26,1.23330060808615,0.0897094189077755
Maine,2020-05-03,32,1,1185,57,1344212,2020-04-27,1.07965940955461,0.0825636185910757
Maine,2020-05-04,20,0,1205,57,1344212,2020-04-28,1.11960609003691,0.0827636636845566
Maine,2020-05-05,21,4,1226,61,1344212,2020-04-29,1.12184406785323,0.0820373630991676
Maine,2020-05-06,28,1,1254,62,1344212,2020-04-30,1.16329952345363,0.0824641167971433
Maine,2020-05-07,76,0,1330,62,1344212,2020-05-01,1.33795536157296,0.0870934757320689
Maine,2020-05-08,44,1,1374,63,1344212,2020-05-02,1.35029781369682,0.0850607669265714
Maine,2020-05-09,34,1,1408,64,1344212,2020-05-03,1.27502680853296,0.0796891755333099
Maine,2020-05-10,28,0,1436,64,1344212,2020-05-04,1.17849931169715,0.0742384785478918
Maryland,2020-03-08,2,0,5,0,6045680,2020-03-02,4.84250282632051,1.97694350041177
Maryland,2020-03-09,0,0,5,0,6045680,2020-03-03,3.02005976539139,1.23293423631973
Maryland,2020-03-10,3,0,8,0,6045680,2020-03-04,3.23126163796667,1.07708721265556
Maryland,2020-03-11,1,0,9,0,6045680,2020-03-05,2.64836703401216,0.837487190758305
Maryland,2020-03-12,3,0,12,0,6045680,2020-03-06,2.59710754626784,0.720308032766397
Maryland,2020-03-13,6,0,18,0,6045680,2020-03-07,2.48505409746407,0.621263524366017
Maryland,2020-03-14,9,0,27,0,6045680,2020-03-08,3.02631604732342,0.605263209464684
Maryland,2020-03-15,-3,0,24,0,6045680,2020-03-09,2.06149802698845,0.429852053177313
Maryland,2020-03-16,18,0,42,0,6045680,2020-03-10,2.89996699207116,0.452898754504539
Maryland,2020-03-17,18,0,60,0,6045680,2020-03-11,3.02952784019973,0.404837686490022
Maryland,2020-03-18,25,0,85,0,6045680,2020-03-12,3.09669133749738,0.346220616798944
Maryland,2020-03-19,22,1,107,1,6045680,2020-03-13,2.73056528729667,0.274432137076729
Maryland,2020-03-20,42,1,149,2,6045680,2020-03-14,2.73268448560635,0.235192033404284
Maryland,2020-03-21,44,0,193,2,6045680,2020-03-15,2.56737361234674,0.196908567396055
Maryland,2020-03-22,51,1,244,3,6045680,2020-03-16,2.52089774000808,0.169573932615022
Maryland,2020-03-23,46,0,290,3,6045680,2020-03-17,2.17336969810596,0.137731708304481
Maryland,2020-03-24,59,1,349,4,6045680,2020-03-18,2.00740382301462,0.11787881136053
Maryland,2020-03-25,76,0,425,4,6045680,2020-03-19,1.94210536287272,0.105170901839999
Maryland,2020-03-26,158,0,583,4,6045680,2020-03-20,2.2664872429274,0.103775321957006
Maryland,2020-03-27,192,1,775,5,6045680,2020-03-21,2.4077887829124,0.0961578216872697
Maryland,2020-03-28,220,0,995,5,6045680,2020-03-22,2.40735965796223,0.084953877478372
Maryland,2020-03-29,244,5,1239,10,6045680,2020-03-23,2.32060703014773,0.0735312475471102
Maryland,2020-03-30,174,5,1413,15,6045680,2020-03-24,2.0547679312787,0.0612885890598119
Maryland,2020-03-31,247,3,1660,18,6045680,2020-03-25,1.94351642480743,0.0536563711857537
Maryland,2020-04-01,326,13,1986,31,6045680,2020-03-26,1.92623383959233,0.048738088631754
Maryland,2020-04-02,345,5,2331,36,6045680,2020-03-27,1.80721926896886,0.0432131518513602
Maryland,2020-04-03,427,7,2758,43,6045680,2020-03-28,1.74095545436132,0.0390856037744658
Maryland,2020-04-04,367,11,3125,54,6045680,2020-03-29,1.61262971589403,0.0349335670427136
Maryland,2020-04-05,492,13,3617,67,6045680,2020-03-30,1.58068833510899,0.0324077609993764
Maryland,2020-04-06,428,24,4045,91,6045680,2020-03-31,1.55551302272627,0.0303143472972596
Maryland,2020-04-07,326,12,4371,103,6045680,2020-04-01,1.43029113233321,0.027465000006921
Maryland,2020-04-08,1158,21,5529,124,6045680,2020-04-02,1.69623417030269,0.0284930507175644
Maryland,2020-04-09,656,14,6185,138,6045680,2020-04-03,1.63890252324258,0.0263961709712443
Maryland,2020-04-10,783,33,6968,171,6045680,2020-04-04,1.56620687502869,0.0241355113955978
Maryland,2020-04-11,726,35,7694,206,6045680,2020-04-05,1.51091116076338,0.022350169917551
Maryland,2020-04-12,531,30,8225,236,6045680,2020-04-06,1.36926943855012,0.0201690554959334
Maryland,2020-04-13,711,26,8936,262,6045680,2020-04-07,1.33292622095854,0.0190573665454638
Maryland,2020-04-14,536,40,9472,302,6045680,2020-04-08,1.29489332571671,0.0181285790744952
Maryland,2020-04-15,560,9,10032,311,6045680,2020-04-09,1.07141147241749,0.0159645654416192
Maryland,2020-04-16,752,8,10784,319,6045680,2020-04-10,1.05771864409249,0.0155952105946502
Maryland,2020-04-17,788,15,11572,334,6045680,2020-04-11,1.04663717254723,0.0154234431809663
Maryland,2020-04-18,754,87,12326,421,6045680,2020-04-12,1.04112115719257,0.0152957269415624
Maryland,2020-04-19,521,40,12847,461,6045680,2020-04-13,1.02916872814906,0.0151364710551233
Maryland,2020-04-20,837,121,13684,582,6045680,2020-04-14,1.04938164940626,0.015227632271943
Maryland,2020-04-21,509,70,14193,652,6045680,2020-04-15,1.03417681706965,0.0150498373615508
Maryland,2020-04-22,582,46,14775,698,6045680,2020-04-16,1.02957445631888,0.014948080191557
Maryland,2020-04-23,962,50,15737,748,6045680,2020-04-17,1.06795026194692,0.0151730547694269
Maryland,2020-04-24,879,50,16616,798,6045680,2020-04-18,1.0752169841501,0.0151378964660292
Maryland,2020-04-25,1150,77,17766,875,6045680,2020-04-19,1.14095385037742,0.0154678059615069
Maryland,2020-04-26,815,35,18581,910,6045680,2020-04-20,1.17308869987603,0.0154904537792524
Maryland,2020-04-27,906,35,19487,945,6045680,2020-04-21,1.14610507747057,0.0150439102793368
Maryland,2020-04-28,626,71,20113,1016,6045680,2020-04-22,1.13004315310569,0.014685796222458
Maryland,2020-04-29,736,62,20849,1078,6045680,2020-04-23,1.12606046342274,0.014447362481798
Maryland,2020-04-30,893,62,21742,1140,6045680,2020-04-24,1.08303909454742,0.0139749888398265
Maryland,2020-05-01,1730,-60,23472,1080,6045680,2020-04-25,1.20979192096697,0.0146097776119999
Maryland,2020-05-02,1001,171,24473,1251,6045680,2020-04-26,1.14421892220171,0.0139705208735075
Maryland,2020-05-03,989,30,25462,1281,6045680,2020-04-27,1.13003581066603,0.0136218116916086
Maryland,2020-05-04,946,36,26408,1317,6045680,2020-04-28,1.10467570598034,0.0132775824099228
Maryland,2020-05-05,709,73,27117,1390,6045680,2020-04-29,1.09041367829963,0.013028284115109
Maryland,2020-05-06,1046,47,28163,1437,6045680,2020-04-30,1.1153472727972,0.0130407612661232
Maryland,2020-05-07,1211,66,29374,1503,6045680,2020-05-01,1.13762098969362,0.0130211686893039
Maryland,2020-05-08,1111,57,30485,1560,6045680,2020-05-02,1.0163356932631,0.0121354056287715
Maryland,2020-05-09,1049,54,31534,1614,6045680,2020-05-03,1.00851972833799,0.0120010858238975
Maryland,2020-05-10,1053,30,32587,1644,6045680,2020-05-04,1.01636095731868,0.0120399605694478
Massachusetts,2020-03-08,16,0,22,0,6892503,2020-03-02,9.53215621830159,2.03226253415548
Massachusetts,2020-03-09,0,0,22,0,6892503,2020-03-03,4.30575645646394,0.917990360970906
Massachusetts,2020-03-10,19,0,41,0,6892503,2020-03-04,4.391594637049,0.694372080662766
Massachusetts,2020-03-11,51,0,92,0,6892503,2020-03-05,6.2947732702349,0.659871536978968
Massachusetts,2020-03-12,15,0,107,0,6892503,2020-03-06,3.89069755017014,0.37789795251883
Massachusetts,2020-03-13,16,0,123,0,6892503,2020-03-07,2.63140829133518,0.242240768233036
Massachusetts,2020-03-14,15,0,138,0,6892503,2020-03-08,2.16594520378748,0.187811267964708
Massachusetts,2020-03-15,0,0,138,0,6892503,2020-03-09,1.51507442578368,0.140068680213005
Massachusetts,2020-03-16,49,0,187,0,6892503,2020-03-10,1.86928511207723,0.145084662243376
Massachusetts,2020-03-17,30,0,217,0,6892503,2020-03-11,1.7354491883003,0.130444348918666
Massachusetts,2020-03-18,35,0,252,0,6892503,2020-03-12,1.35144593490243,0.106508860476614
Massachusetts,2020-03-19,76,0,328,0,6892503,2020-03-13,1.69166429283131,0.113537073352308
Massachusetts,2020-03-20,85,1,413,1,6892503,2020-03-14,1.98809342662216,0.116544100659582
Massachusetts,2020-03-21,110,0,523,1,6892503,2020-03-15,2.21903144623071,0.112945726791307
Massachusetts,2020-03-22,117,4,640,5,6892503,2020-03-16,2.33728686485693,0.104214470407003
Massachusetts,2020-03-23,137,4,777,9,6892503,2020-03-17,2.1673445759384,0.0891526430218575
Massachusetts,2020-03-24,382,2,1159,11,6892503,2020-03-18,2.76394600968668,0.0900064658008678
Massachusetts,2020-03-25,679,4,1838,15,6892503,2020-03-19,3.53541637583523,0.0887466780993862
Massachusetts,2020-03-26,579,10,2417,25,6892503,2020-03-20,3.18930211117302,0.0697625773892202
Massachusetts,2020-03-27,823,10,3240,35,6892503,2020-03-21,2.97015949496626,0.0558521722352951
Massachusetts,2020-03-28,1017,9,4257,44,6892503,2020-03-22,2.80660541279894,0.0459236137301144
Massachusetts,2020-03-29,698,4,4955,48,6892503,2020-03-23,2.37045709624747,0.0360820647285665
Massachusetts,2020-03-30,797,8,5752,56,6892503,2020-03-24,2.09788580384712,0.0297400475327032
Massachusetts,2020-03-31,868,33,6620,89,6892503,2020-03-25,1.85733317397203,0.0251312429067102
Massachusetts,2020-04-01,1118,33,7738,122,6892503,2020-03-26,1.68136945929593,0.0218877110740368
Massachusetts,2020-04-02,1228,32,8966,154,6892503,2020-03-27,1.61656900391848,0.0199743933190121
Massachusetts,2020-04-03,1436,38,10402,192,6892503,2020-03-28,1.55865009027352,0.0184162479472858
Massachusetts,2020-04-04,1334,24,11736,216,6892503,2020-03-29,1.44934806377576,0.0167579887963543
Massachusetts,2020-04-05,764,15,12500,231,6892503,2020-03-30,1.32396105045089,0.0152411173989785
Massachusetts,2020-04-06,1337,29,13837,260,6892503,2020-03-31,1.31470380152437,0.0146204604470323
Massachusetts,2020-04-07,1365,96,15202,356,6892503,2020-04-01,1.30691830602322,0.0141068122055335
Massachusetts,2020-04-08,1588,77,16790,433,6892503,2020-04-02,1.29157516538564,0.0135744869880577
Massachusetts,2020-04-09,2151,70,18941,503,6892503,2020-04-03,1.33702175574898,0.0133862907561096
Massachusetts,2020-04-10,2033,96,20974,599,6892503,2020-04-04,1.32545774423771,0.0128904111819879
Massachusetts,2020-04-11,1886,87,22860,686,6892503,2020-04-05,1.30098549723036,0.0123345254514592
Massachusetts,2020-04-12,2615,70,25475,756,6892503,2020-04-06,1.42197660756531,0.0124830880429763
Massachusetts,2020-04-13,1392,88,26867,844,6892503,2020-04-07,1.32119546792824,0.0115738594174639
Massachusetts,2020-04-14,1297,0,28164,844,6892503,2020-04-08,1.21791045133003,0.010697014803241
Massachusetts,2020-04-15,1754,264,29918,1108,6892503,2020-04-09,1.16931902346619,0.0102050982684137
Massachusetts,2020-04-16,2263,0,32181,1108,6892503,2020-04-10,1.13359648863939,0.00985140331112867
Massachusetts,2020-04-17,2221,137,34402,1245,6892503,2020-04-11,1.11398843300327,0.00961299783475448
Massachusetts,2020-04-18,1970,159,36372,1404,6892503,2020-04-12,1.09205374664089,0.00939438003261381
Massachusetts,2020-04-19,1705,302,38077,1706,6892503,2020-04-13,0.996530630659657,0.00887674377281261
Massachusetts,2020-04-20,0,0,38077,1706,6892503,2020-04-14,0.879744408779325,0.00830872412049135
Massachusetts,2020-04-21,3122,255,41199,1961,6892503,2020-04-15,1.04061837569091,0.00911421595537712
Massachusetts,2020-04-22,1745,221,42944,2182,6892503,2020-04-16,1.04740272161976,0.00917680474864091
Massachusetts,2020-04-23,3079,178,46023,2360,6892503,2020-04-17,1.09997606438624,0.00934906384311608
Massachusetts,2020-04-24,4946,196,50969,2556,6892503,2020-04-18,1.29430102541697,0.010055420860247
Massachusetts,2020-04-25,2379,174,53348,2730,6892503,2020-04-19,1.26559208330591,0.00971322111293044
Massachusetts,2020-04-26,1590,169,54938,2899,6892503,2020-04-20,1.18320790197734,0.00911184910168128
Massachusetts,2020-04-27,1524,104,56462,3003,6892503,2020-04-21,1.23285341995569,0.00909217563259487
Massachusetts,2020-04-28,1840,150,58302,3153,6892503,2020-04-22,1.09670338916114,0.00838571970017723
Massachusetts,2020-04-29,1963,252,60265,3405,6892503,2020-04-23,1.07442089456832,0.00816348179257924
Massachusetts,2020-04-30,1940,157,62205,3562,6892503,2020-04-24,0.987107882831948,0.00775952439864838
Massachusetts,2020-05-01,2106,154,64311,3716,6892503,2020-04-25,0.809823239437594,0.00701073404864725
Massachusetts,2020-05-02,1952,130,66263,3846,6892503,2020-04-26,0.805556988084168,0.0070881394193573
Massachusetts,2020-05-03,1824,158,68087,4004,6892503,2020-04-27,0.858962689396536,0.00749051060905969
Massachusetts,2020-05-04,1000,86,69087,4090,6892503,2020-04-28,0.856309496786785,0.00762075268970707
Massachusetts,2020-05-05,1184,122,70271,4212,6892503,2020-04-29,0.838238270840797,0.00766161650549067
Massachusetts,2020-05-06,1754,208,72025,4420,6892503,2020-04-30,0.853278060983832,0.00786807433698527
Massachusetts,2020-05-07,1696,132,73721,4552,6892503,2020-05-01,0.865597494232847,0.0080657787927392
Massachusetts,2020-05-08,1612,150,75333,4702,6892503,2020-05-02,0.855191139553399,0.00814541636634135
Massachusetts,2020-05-09,1410,138,76743,4840,6892503,2020-05-03,0.839560570929675,0.00820069526037465
Massachusetts,2020-05-10,1050,139,77793,4979,6892503,2020-05-04,0.805554102865637,0.00817621304361559
Michigan,2020-03-08,0,0,0,0,9986857,2020-03-02,5,5
Michigan,2020-03-09,0,0,0,0,9986857,2020-03-03,5,5
Michigan,2020-03-10,0,0,0,0,9986857,2020-03-04,5,5
Michigan,2020-03-11,2,0,2,0,9986857,2020-03-05,15,8.66025403784439
Michigan,2020-03-12,0,0,2,0,9986857,2020-03-06,6.51690738866037,3.76253823512692
Michigan,2020-03-13,14,0,16,0,9986857,2020-03-07,19.0436544995683,4.61876464702877
Michigan,2020-03-14,9,0,25,0,9986857,2020-03-08,8.55271478118217,1.67732536782467
Michigan,2020-03-15,7,0,32,0,9986857,2020-03-09,4.41054335620513,0.767777048939166
Michigan,2020-03-16,22,0,54,0,9986857,2020-03-10,4.29802586179062,0.579545688976538
Michigan,2020-03-17,9,0,63,0,9986857,2020-03-11,3.12461606404162,0.390577008005202
Michigan,2020-03-18,56,1,119,1,9986857,2020-03-12,3.92893142655431,0.361687454674895
Michigan,2020-03-19,140,0,259,1,9986857,2020-03-13,5.69468282174441,0.354535466569021
Michigan,2020-03-20,143,0,402,1,9986857,2020-03-14,4.75449077287,0.241684348507412
Michigan,2020-03-21,138,2,540,3,9986857,2020-03-15,3.63688053737317,0.160104738266412
Michigan,2020-03-22,495,6,1035,9,9986857,2020-03-16,4.57630567026449,0.144426926296784
Michigan,2020-03-23,294,6,1329,15,9986857,2020-03-17,3.57995135214473,0.100219397582606
Michigan,2020-03-24,464,9,1793,24,9986857,2020-03-18,3.13261787578826,0.0752937431016992
Michigan,2020-03-25,503,19,2296,43,9986857,2020-03-19,2.75212040601654,0.0589710000526113
Michigan,2020-03-26,549,18,2845,61,9986857,2020-03-20,2.38897395371047,0.0469692040316878
Michigan,2020-03-27,789,31,3634,92,9986857,2020-03-21,2.29601493621804,0.0403805152921583
Michigan,2020-03-28,1016,19,4650,111,9986857,2020-03-22,2.30312166603546,0.0359205636219356
Michigan,2020-03-29,838,21,5488,132,9986857,2020-03-23,1.97173152006222,0.0295442298065898
Michigan,2020-03-30,1010,52,6498,184,9986857,2020-03-24,1.87070782372235,0.0260172081193232
Michigan,2020-03-31,1117,75,7615,259,9986857,2020-03-25,1.77706514971341,0.0232878800176094
Michigan,2020-04-01,1700,76,9315,335,9986857,2020-03-26,1.83190860742706,0.0218642833609897
Michigan,2020-04-02,1476,82,10791,417,9986857,2020-03-27,1.77290416689602,0.0198876585158458
Michigan,2020-04-03,1953,62,12744,479,9986857,2020-03-28,1.74087421425471,0.0182383005948822
Michigan,2020-04-04,1481,61,14225,540,9986857,2020-03-29,1.58039511865043,0.0161500403195764
Michigan,2020-04-05,1493,77,15718,617,9986857,2020-03-30,1.48749521697913,0.0147060668422293
Michigan,2020-04-06,1503,110,17221,727,9986857,2020-03-31,1.40484522510422,0.013565945782637
Michigan,2020-04-07,1749,118,18970,845,9986857,2020-04-01,1.3611290118295,0.0127728143233308
Michigan,2020-04-08,1376,114,20346,959,9986857,2020-04-02,1.22348617588154,0.0116485519279073
Michigan,2020-04-09,1158,117,21504,1076,9986857,2020-04-03,1.12120233330208,0.0108319880411948
Michigan,2020-04-10,930,200,22434,1276,9986857,2020-04-04,0.980762635281798,0.00996275877738652
Michigan,2020-04-11,1171,108,23605,1384,9986857,2020-04-05,0.942366960494121,0.00972961113979156
Michigan,2020-04-12,639,95,24244,1479,9986857,2020-04-06,0.865805830526275,0.00937610310885248
Michigan,2020-04-13,1391,123,25635,1602,9986857,2020-04-07,0.874644861978228,0.00953464854236852
Michigan,2020-04-14,1366,166,27001,1768,9986857,2020-04-08,0.860475472593054,0.00960122496266208
Michigan,2020-04-15,1058,153,28059,1921,9986857,2020-04-09,0.851826506201903,0.00969865101763405
Michigan,2020-04-16,750,75,28809,1996,9986857,2020-04-10,0.83403773959975,0.00975766420940602
Michigan,2020-04-17,1214,231,30023,2227,9986857,2020-04-11,0.898588206647026,0.0103143016021222
Michigan,2020-04-18,768,81,30791,2308,9986857,2020-04-12,0.876474964328008,0.0103386942739168
Michigan,2020-04-19,633,83,31424,2391,9986857,2020-04-13,0.898111955419881,0.0105983440629288
Michigan,2020-04-20,576,77,32000,2468,9986857,2020-04-14,0.816812364895329,0.0102373838239969
Michigan,2020-04-21,667,107,32667,2575,9986857,2020-04-15,0.752075168594893,0.0099904406331225
Michigan,2020-04-22,1299,238,33966,2813,9986857,2020-04-16,0.825900686810202,0.0107450288018633
Michigan,2020-04-23,1330,164,35296,2977,9986857,2020-04-17,0.951993864765412,0.0118189454704358
Michigan,2020-04-24,1370,108,36666,3085,9986857,2020-04-18,0.996846561848814,0.012229635223696
Michigan,2020-04-25,408,70,37074,3155,9986857,2020-04-19,0.946224145146969,0.0119364707381297
Michigan,2020-04-26,704,160,37778,3315,9986857,2020-04-20,0.963640210691541,0.0120880747371761
Michigan,2020-04-27,432,92,38210,3407,9986857,2020-04-21,0.951645331096248,0.0120752006663006
Michigan,2020-04-28,1052,161,39262,3568,9986857,2020-04-22,1.02026240481639,0.0125623694154712
Michigan,2020-04-29,1137,102,40399,3670,9986857,2020-04-23,0.997241901759389,0.0124325435719373
Michigan,2020-04-30,980,119,41379,3789,9986857,2020-04-24,0.940871319886502,0.0120624528190577
Michigan,2020-05-01,977,77,42356,3866,9986857,2020-04-25,0.88747857300127,0.0117642320821007
Michigan,2020-05-02,851,155,43207,4021,9986857,2020-04-26,0.97682292261206,0.0124722255640981
Michigan,2020-05-03,594,32,43801,4053,9986857,2020-04-27,0.973065873267424,0.0125371770766023
Michigan,2020-05-04,189,86,43990,4139,9986857,2020-04-28,0.938150710321581,0.0123387489239783
Michigan,2020-05-05,461,44,44451,4183,9986857,2020-04-29,0.851382703163676,0.0118179226682988
Michigan,2020-05-06,728,73,45179,4256,9986857,2020-04-30,0.804806255410079,0.0116394369324111
Michigan,2020-05-07,566,89,45745,4345,9986857,2020-05-01,0.766061006414987,0.0115923573595982
Michigan,2020-05-08,641,54,46386,4399,9986857,2020-05-02,0.744006712609692,0.0117184576488184
Michigan,2020-05-09,429,131,46815,4530,9986857,2020-05-03,0.705870222034117,0.01174982558668
Michigan,2020-05-10,367,25,47182,4555,9986857,2020-05-04,0.706224450152243,0.012143837510094
Minnesota,2020-03-08,0,0,1,0,5639632,2020-03-02,3.66070465155515,2.58850908303578
Minnesota,2020-03-09,1,0,2,0,5639632,2020-03-03,4.23255620446024,2.44366746400534
Minnesota,2020-03-10,0,0,2,0,5639632,2020-03-04,3.12162306547093,1.80226991715819
Minnesota,2020-03-11,3,0,5,0,5639632,2020-03-05,4.72832398663828,1.93033018430435
Minnesota,2020-03-12,4,0,9,0,5639632,2020-03-06,5.28863359038788,1.67241278556997
Minnesota,2020-03-13,5,0,14,0,5639632,2020-03-07,4.32909910813719,1.15700040400271
Minnesota,2020-03-14,7,0,21,0,5639632,2020-03-08,4.00968789070827,0.874985632015164
Minnesota,2020-03-15,0,0,21,0,5639632,2020-03-09,2.58384675446468,0.563841587452399
Minnesota,2020-03-16,32,0,53,0,5639632,2020-03-10,4.67301141973268,0.648030087872113
Minnesota,2020-03-17,6,0,59,0,5639632,2020-03-11,3.3299498189939,0.437243832333967
Minnesota,2020-03-18,18,0,77,0,5639632,2020-03-12,2.74494119054294,0.321271065927058
Minnesota,2020-03-19,12,0,89,0,5639632,2020-03-13,2.24047010285242,0.248941122539158
Minnesota,2020-03-20,24,0,113,0,5639632,2020-03-14,2.16670837995576,0.216670837995576
Minnesota,2020-03-21,21,1,134,1,5639632,2020-03-15,1.996928907883,0.187029528186055
Minnesota,2020-03-22,33,0,167,1,5639632,2020-03-16,2.11889080012091,0.174763167690461
Minnesota,2020-03-23,67,0,234,1,5639632,2020-03-17,2.15224593165737,0.159535082612766
Minnesota,2020-03-24,27,0,261,1,5639632,2020-03-18,1.94375496346403,0.136424853599918
Minnesota,2020-03-25,25,0,286,1,5639632,2020-03-19,1.66339329476359,0.114785042435736
Minnesota,2020-03-26,58,1,344,2,5639632,2020-03-20,1.75300494881617,0.10956280930101
Minnesota,2020-03-27,52,2,396,4,5639632,2020-03-21,1.69329080607621,0.100478323531977
Minnesota,2020-03-28,45,1,441,5,5639632,2020-03-22,1.59497807298323,0.0908823103188255
Minnesota,2020-03-29,62,4,503,9,5639632,2020-03-23,1.54148345998126,0.0839699546626111
Minnesota,2020-03-30,73,1,576,10,5639632,2020-03-24,1.40338233160427,0.075775523342181
Minnesota,2020-03-31,53,2,629,12,5639632,2020-03-25,1.37685251643429,0.0716760790191121
Minnesota,2020-04-01,60,5,689,17,5639632,2020-03-26,1.39393623975876,0.0693509199670716
Minnesota,2020-04-02,53,1,742,18,5639632,2020-03-27,1.2712664508789,0.0636429259847105
Minnesota,2020-04-03,46,4,788,22,5639632,2020-03-28,1.17169209683193,0.0591040478539212
Minnesota,2020-04-04,77,2,865,24,5639632,2020-03-29,1.21346927900283,0.0588619060090678
Minnesota,2020-04-05,70,5,935,29,5639632,2020-03-30,1.18685390472238,0.0570365587381458
Minnesota,2020-04-06,51,1,986,30,5639632,2020-03-31,1.079799510907,0.0532625819583832
Minnesota,2020-04-07,83,4,1069,34,5639632,2020-04-01,1.12909088194828,0.0537662324737278
Minnesota,2020-04-08,85,5,1154,39,5639632,2020-04-02,1.16686429757394,0.0540539447797335
Minnesota,2020-04-09,86,11,1240,50,5639632,2020-04-03,1.20892143635535,0.0541187560654815
Minnesota,2020-04-10,96,7,1336,57,5639632,2020-04-04,1.27647217394419,0.0544785048243248
Minnesota,2020-04-11,91,7,1427,64,5639632,2020-04-05,1.2413824411221,0.0523180321899763
Minnesota,2020-04-12,194,6,1621,70,5639632,2020-04-06,1.4346048756998,0.0547335899168356
Minnesota,2020-04-13,0,0,1621,70,5639632,2020-04-07,1.23321255393968,0.0489000585714693
Minnesota,2020-04-14,74,9,1695,79,5639632,2020-04-08,1.13699399738076,0.0454071664572636
Minnesota,2020-04-15,114,8,1809,87,5639632,2020-04-09,1.14866988873573,0.0448480244230062
Minnesota,2020-04-16,0,0,1809,87,5639632,2020-04-10,0.96845712873918,0.0405642053385359
Minnesota,2020-04-17,261,24,2070,111,5639632,2020-04-11,1.23751817979319,0.0456465457235043
Minnesota,2020-04-18,139,10,2209,121,5639632,2020-04-12,1.28515997302717,0.045927870545141
Minnesota,2020-04-19,147,13,2356,134,5639632,2020-04-13,1.13833100320463,0.0419594374660644
Minnesota,2020-04-20,114,9,2470,143,5639632,2020-04-14,1.26084311786464,0.0432465621600911
Minnesota,2020-04-21,97,17,2567,160,5639632,2020-04-15,1.23976922688553,0.0419598310056299
Minnesota,2020-04-22,155,19,2722,179,5639632,2020-04-16,1.22981346401769,0.0406786138399263
Minnesota,2020-04-23,220,21,2942,200,5639632,2020-04-17,1.4527323365604,0.0431398942706078
Minnesota,2020-04-24,243,21,3185,221,5639632,2020-04-18,1.32511643013845,0.039666322775943
Minnesota,2020-04-25,261,23,3446,244,5639632,2020-04-19,1.35720369848787,0.0385731150062274
Minnesota,2020-04-26,156,28,3602,272,5639632,2020-04-20,1.27438904994437,0.0360884977756985
Minnesota,2020-04-27,209,14,3811,286,5639632,2020-04-21,1.28547700863883,0.0350903787296213
Minnesota,2020-04-28,370,15,4181,301,5639632,2020-04-22,1.45943149336446,0.0363159534220989
Minnesota,2020-04-29,463,18,4644,319,5639632,2020-04-23,1.60191739258356,0.0365300674899093
Minnesota,2020-04-30,492,24,5136,343,5639632,2020-04-24,1.63396430859853,0.0348758903464789
Minnesota,2020-05-01,594,27,5730,370,5639632,2020-04-25,1.67211756432265,0.0331388634237299
Minnesota,2020-05-02,502,24,6232,394,5639632,2020-04-26,1.60614297579566,0.0304239583861387
Minnesota,2020-05-03,431,24,6663,418,5639632,2020-04-27,1.55598588258567,0.0281192063736206
Minnesota,2020-05-04,571,9,7234,427,5639632,2020-04-28,1.55139133123305,0.0265127320334742
Minnesota,2020-05-05,617,28,7851,455,5639632,2020-04-29,1.48837503233482,0.0245651931830449
Minnesota,2020-05-06,728,30,8579,485,5639632,2020-04-30,1.43839939069494,0.0229272488897898
Minnesota,2020-05-07,786,23,9365,508,5639632,2020-05-01,1.40861634584453,0.0216582089863532
Minnesota,2020-05-08,723,26,10088,534,5639632,2020-05-02,1.33184513321856,0.0201725264487616
Minnesota,2020-05-09,702,24,10790,558,5639632,2020-05-03,1.29246928361725,0.0191419172517385
Minnesota,2020-05-10,481,20,11271,578,5639632,2020-05-04,1.22583891111008,0.0180563535058763
Mississippi,2020-03-08,0,0,0,0,2976149,2020-03-02,5,5
Mississippi,2020-03-09,0,0,0,0,2976149,2020-03-03,5,5
Mississippi,2020-03-10,0,0,0,0,2976149,2020-03-04,5,5
Mississippi,2020-03-11,0,0,0,0,2976149,2020-03-05,5,5
Mississippi,2020-03-12,1,0,1,0,2976149,2020-03-06,10,7.07106781186548
Mississippi,2020-03-13,5,0,6,0,2976149,2020-03-07,21.2011656213494,8.01328739125468
Mississippi,2020-03-14,0,0,6,0,2976149,2020-03-08,5.84699810859255,2.20995755880013
Mississippi,2020-03-15,0,0,6,0,2976149,2020-03-09,2.86825760218485,1.08409947306451
Mississippi,2020-03-16,6,0,12,0,2976149,2020-03-10,3.85205084026621,1.06836667848261
Mississippi,2020-03-17,9,0,21,0,2976149,2020-03-11,4.52864169619569,0.965509653746809
Mississippi,2020-03-18,13,0,34,0,2976149,2020-03-12,4.45623437361935,0.753241088186373
Mississippi,2020-03-19,16,1,50,1,2976149,2020-03-13,3.88708035698204,0.549716175887806
Mississippi,2020-03-20,30,0,80,1,2976149,2020-03-14,3.72793422334352,0.430464765473719
Mississippi,2020-03-21,60,0,140,1,2976149,2020-03-15,4.41175221911958,0.37970317493875
Mississippi,2020-03-22,67,0,207,1,2976149,2020-03-16,4.10186542944104,0.288606244496878
Mississippi,2020-03-23,42,0,249,1,2976149,2020-03-17,3.00959765401811,0.19508324057284
Mississippi,2020-03-24,71,0,320,1,2976149,2020-03-18,2.6289042456407,0.151779857389441
Mississippi,2020-03-25,57,2,377,3,2976149,2020-03-19,2.25166653074696,0.121401723169905
Mississippi,2020-03-26,108,3,485,6,2976149,2020-03-20,2.23712510410588,0.107138861402036
Mississippi,2020-03-27,94,2,579,8,2976149,2020-03-21,2.05148120050188,0.0917450283777015
Mississippi,2020-03-28,84,5,663,13,2976149,2020-03-22,1.74874881876014,0.0763944468515966
Mississippi,2020-03-29,96,1,759,14,2976149,2020-03-23,1.56941144397564,0.0667381631753342
Mississippi,2020-03-30,88,2,847,16,2976149,2020-03-24,1.50278374984633,0.061402079418631
Mississippi,2020-03-31,90,4,937,20,2976149,2020-03-25,1.39580224420684,0.0561474005676686
Mississippi,2020-04-01,136,2,1073,22,2976149,2020-03-26,1.44049722986255,0.0545627232976959
Mississippi,2020-04-02,104,4,1177,26,2976149,2020-03-27,1.31428719072278,0.0499256419627619
Mississippi,2020-04-03,181,3,1358,29,2976149,2020-03-28,1.37144957709482,0.0491057720576347
Mississippi,2020-04-04,97,6,1455,35,2976149,2020-03-29,1.29840696609919,0.0461077832823455
Mississippi,2020-04-05,183,8,1638,43,2976149,2020-03-30,1.344939185029,0.0453378906783989
Mississippi,2020-04-06,100,8,1738,51,2976149,2020-03-31,1.27446845081441,0.0426723599660095
Mississippi,2020-04-07,177,9,1915,60,2976149,2020-04-01,1.31229393056795,0.0419410959114907
Mississippi,2020-04-08,88,7,2003,67,2976149,2020-04-02,1.17339119280764,0.0384563430878885
Mississippi,2020-04-09,257,9,2260,76,2976149,2020-04-03,1.30116598427347,0.039520102300239
Mississippi,2020-04-10,209,6,2469,82,2976149,2020-04-04,1.2677466758061,0.0380171964357686
Mississippi,2020-04-11,173,11,2642,93,2976149,2020-04-05,1.27467741491291,0.0369821427479512
Mississippi,2020-04-12,139,3,2781,96,2976149,2020-04-06,1.15973927183409,0.0342884103775425
Mississippi,2020-04-13,161,2,2942,98,2976149,2020-04-07,1.16922481041085,0.0336825139913921
Mississippi,2020-04-14,145,13,3087,111,2976149,2020-04-08,1.09983658992752,0.0321128727119459
Mississippi,2020-04-15,273,11,3360,122,2976149,2020-04-09,1.23840397527803,0.0336056618018925
Mississippi,2020-04-16,264,7,3624,129,2976149,2020-04-10,1.19794705667117,0.0324243515256464
Mississippi,2020-04-17,169,11,3793,140,2976149,2020-04-11,1.10927253002844,0.0304740600594991
Mississippi,2020-04-18,181,12,3974,152,2976149,2020-04-12,1.08246389982047,0.0296482010376194
Mississippi,2020-04-19,300,7,4274,159,2976149,2020-04-13,1.18992460951439,0.0307853537075167
Mississippi,2020-04-20,238,10,4512,169,2976149,2020-04-14,1.21261193259206,0.0305938226673423
Mississippi,2020-04-21,204,14,4716,183,2976149,2020-04-15,1.20322373432195,0.0298024925341635
Mississippi,2020-04-22,178,10,4894,193,2976149,2020-04-16,1.08409144658693,0.0276701636672066
Mississippi,2020-04-23,259,8,5153,201,2976149,2020-04-17,1.05041447086348,0.0268543707643641
Mississippi,2020-04-24,281,8,5434,209,2976149,2020-04-18,1.11306157713224,0.0274683526734317
Mississippi,2020-04-25,284,12,5718,221,2976149,2020-04-19,1.16085133204915,0.0277893819791888
Mississippi,2020-04-26,193,6,5911,227,2976149,2020-04-20,1.05615477154674,0.0260958000899128
Mississippi,2020-04-27,183,2,6094,229,2976149,2020-04-21,0.998726829244497,0.0251018805869927
Mississippi,2020-04-28,248,10,6342,239,2976149,2020-04-22,1.02273846708604,0.0253554203263268
Mississippi,2020-04-29,227,11,6569,250,2976149,2020-04-23,1.05117219008483,0.0256765609756609
Mississippi,2020-04-30,246,11,6815,261,2976149,2020-04-24,1.0337608485672,0.0253497660467153
Mississippi,2020-05-01,397,20,7212,281,2976149,2020-04-25,1.09576284096942,0.0259793687726726
Mississippi,2020-05-02,229,10,7441,291,2976149,2020-04-26,1.04596575566386,0.0251911988141149
Mississippi,2020-05-03,109,12,7550,303,2976149,2020-04-27,0.980054243106381,0.0242007145559546
Mississippi,2020-05-04,327,7,7877,310,2976149,2020-04-28,1.06518613948902,0.0252190127730324
Mississippi,2020-05-05,330,32,8207,342,2976149,2020-04-29,1.10760529766366,0.0256406602780093
Mississippi,2020-05-06,217,32,8424,374,2976149,2020-04-30,1.07915431503252,0.0250492406843986
Mississippi,2020-05-07,262,22,8686,396,2976149,2020-05-01,1.06685965812878,0.0246578025712007
Mississippi,2020-05-08,404,13,9090,409,2976149,2020-05-02,1.05458346120489,0.0243286251004836
Mississippi,2020-05-09,288,12,9378,421,2976149,2020-05-03,1.07375045524635,0.0243908241233201
Mississippi,2020-05-10,123,9,9501,430,2976149,2020-05-04,1.06620741707925,0.0241324709853342
Missouri,2020-03-08,1,0,1,0,6626371,2020-03-02,10,7.07106781186548
Missouri,2020-03-09,0,0,1,0,6626371,2020-03-03,6.05747589181412,4.2832822799758
Missouri,2020-03-10,0,0,1,0,6626371,2020-03-04,3.66070465155515,2.58850908303578
Missouri,2020-03-11,0,0,1,0,6626371,2020-03-05,2.82170413630682,1.99524612928469
Missouri,2020-03-12,1,0,2,0,6626371,2020-03-06,3.61068188129305,2.08462815612265
Missouri,2020-03-13,2,0,4,0,6626371,2020-03-07,4.74934747507742,2.12397276060802
Missouri,2020-03-14,0,0,4,0,6626371,2020-03-08,3.12846395698597,1.39909161459572
Missouri,2020-03-15,1,0,5,0,6626371,2020-03-09,2.22734240310288,0.996097804501154
Missouri,2020-03-16,1,0,6,0,6626371,2020-03-10,2.19721270238644,0.897008329534749
Missouri,2020-03-17,6,0,12,0,6626371,2020-03-11,3.71971995032535,1.07379065731518
Missouri,2020-03-18,6,1,18,1,6626371,2020-03-12,4.00209528577221,0.943302905174747
Missouri,2020-03-19,21,0,39,1,6626371,2020-03-13,5.47207060734109,0.887687070450746
Missouri,2020-03-20,34,2,73,3,6626371,2020-03-14,5.78678537179668,0.691653143244916
Missouri,2020-03-21,8,0,81,3,6626371,2020-03-15,3.46654862309681,0.392509339367808
Missouri,2020-03-22,19,0,100,3,6626371,2020-03-16,2.73131146927494,0.278763309513959
Missouri,2020-03-23,87,1,187,4,6626371,2020-03-17,3.79626100862157,0.281397587850792
Missouri,2020-03-24,70,3,257,7,6626371,2020-03-18,3.47059180867313,0.221276851775836
Missouri,2020-03-25,97,1,354,8,6626371,2020-03-19,3.16049392984041,0.172163074654971
Missouri,2020-03-26,166,1,520,9,6626371,2020-03-20,3.15212979891269,0.143575578064599
Missouri,2020-03-27,146,0,666,9,6626371,2020-03-21,2.73306611886368,0.11213906117201
Missouri,2020-03-28,170,1,836,10,6626371,2020-03-22,2.54123593803758,0.0924238574984072
Missouri,2020-03-29,79,3,915,13,6626371,2020-03-23,2.08125803734087,0.0728586044852911
Missouri,2020-03-30,136,0,1051,13,6626371,2020-03-24,1.76484977760463,0.0600066926663411
Missouri,2020-03-31,306,2,1357,15,6626371,2020-03-25,1.90717661159883,0.0574774182868738
Missouri,2020-04-01,256,3,1613,18,6626371,2020-03-26,1.85480617438647,0.0522532443326483
Missouri,2020-04-02,244,4,1857,22,6626371,2020-03-27,1.66291218332622,0.0454612380223224
Missouri,2020-04-03,7,3,1864,25,6626371,2020-03-28,1.29238635279683,0.0373235351484317
Missouri,2020-04-04,446,8,2310,33,6626371,2020-03-29,1.45836405042884,0.0379725655077829
Missouri,2020-04-05,37,11,2347,44,6626371,2020-03-30,1.31016356039749,0.0346100654858282
Missouri,2020-04-06,389,3,2736,47,6626371,2020-03-31,1.42538510005003,0.0347139017165615
Missouri,2020-04-07,394,18,3130,65,6626371,2020-04-01,1.38838513513367,0.0329634870552078
Missouri,2020-04-08,79,21,3209,86,6626371,2020-04-02,1.14854023024805,0.0287404625818124
Missouri,2020-04-09,223,7,3432,93,6626371,2020-04-03,1.07757744685456,0.0271437837482838
Missouri,2020-04-10,465,6,3897,99,6626371,2020-04-04,1.36233587823338,0.0302070782070404
Missouri,2020-04-11,211,17,4108,116,6626371,2020-04-05,1.14362753115032,0.0269630501909617
Missouri,2020-04-12,161,2,4269,118,6626371,2020-04-06,1.16065111584872,0.0264674469423244
Missouri,2020-04-13,246,5,4515,123,6626371,2020-04-07,1.04209125303406,0.0246999315339326
Missouri,2020-04-14,231,26,4746,149,6626371,2020-04-08,0.927872057344578,0.0230745418241907
Missouri,2020-04-15,45,4,4791,153,6626371,2020-04-09,0.914737481402924,0.0229909023711643
Missouri,2020-04-16,383,16,5174,169,6626371,2020-04-10,1.0266792320592,0.0245915602175006
Missouri,2020-04-17,197,15,5371,184,6626371,2020-04-11,0.872870009036647,0.0227275991808606
Missouri,2020-04-18,208,13,5579,197,6626371,2020-04-12,0.882516346040334,0.0230021723487989
Missouri,2020-04-19,164,2,5743,199,6626371,2020-04-13,0.910823266375767,0.0237158178290916
Missouri,2020-04-20,147,1,5890,200,6626371,2020-04-14,0.869252097068237,0.0234334660599431
Missouri,2020-04-21,176,24,6066,224,6626371,2020-04-15,0.85609596484684,0.0235543455077624
Missouri,2020-04-22,211,14,6277,238,6626371,2020-04-16,0.995196640832044,0.0258079445643867
Missouri,2020-04-23,229,14,6506,252,6626371,2020-04-17,0.905233573054881,0.024793941825113
Missouri,2020-04-24,282,20,6788,272,6626371,2020-04-18,0.973971561736641,0.0258647426139872
Missouri,2020-04-25,147,9,6935,281,6626371,2020-04-19,0.944842486465157,0.0256489440388733
Missouri,2020-04-26,185,2,7120,283,6626371,2020-04-20,0.968001601984384,0.0260766301437669
Missouri,2020-04-27,185,20,7305,303,6626371,2020-04-21,1.00457835088055,0.0266963684745725
Missouri,2020-04-28,145,27,7450,330,6626371,2020-04-22,0.984745883691024,0.0264605756115426
Missouri,2020-04-29,210,8,7660,338,6626371,2020-04-23,0.985339195238574,0.0264860816550942
Missouri,2020-04-30,158,12,7818,350,6626371,2020-04-24,0.938263077733047,0.025893589779142
Missouri,2020-05-01,249,10,8067,360,6626371,2020-04-25,0.923435949363738,0.0258108194455546
Missouri,2020-05-02,289,16,8356,376,6626371,2020-04-26,1.04293546788161,0.0276571636132812
Missouri,2020-05-03,262,5,8618,381,6626371,2020-04-27,1.10139350749421,0.0284473421092782
Missouri,2020-05-04,328,5,8946,386,6626371,2020-04-28,1.18471568822728,0.0292366469300091
Missouri,2020-05-05,175,23,9121,409,6626371,2020-04-29,1.16719958114934,0.0285447988189504
Missouri,2020-05-06,202,19,9323,428,6626371,2020-04-30,1.11808181864014,0.0274092356299971
Missouri,2020-05-07,258,21,9581,449,6626371,2020-05-01,1.1509208458497,0.0274028772821357
Missouri,2020-05-08,152,34,9733,483,6626371,2020-05-02,1.05630774838352,0.0258715629219309
Missouri,2020-05-09,178,11,9911,494,6626371,2020-05-03,0.965557642435106,0.024477857903585
Missouri,2020-05-10,157,9,10068,503,6626371,2020-05-04,0.900879496463689,0.0236501008218276
Montana,2020-03-08,0,0,0,0,1068778,2020-03-02,5,5
Montana,2020-03-09,0,0,0,0,1068778,2020-03-03,5,5
Montana,2020-03-10,0,0,0,0,1068778,2020-03-04,5,5
Montana,2020-03-11,0,0,0,0,1068778,2020-03-05,5,5
Montana,2020-03-12,0,0,0,0,1068778,2020-03-06,5,5
Montana,2020-03-13,1,0,1,0,1068778,2020-03-07,10,7.07106781186548
Montana,2020-03-14,4,0,5,0,1068778,2020-03-08,18.1724276754424,7.41886253207754
Montana,2020-03-15,1,0,6,0,1068778,2020-03-09,6.56029612396605,2.4795588672793
Montana,2020-03-16,0,0,6,0,1068778,2020-03-10,3.14700987282682,1.18945792813782
Montana,2020-03-17,2,0,8,0,1068778,2020-03-11,2.80166366975288,0.933887889917628
Montana,2020-03-18,2,0,10,0,1068778,2020-03-12,2.60959701048432,0.786823103437239
Montana,2020-03-19,1,0,11,0,1068778,2020-03-13,2.19544510302527,0.633770410611344
Montana,2020-03-20,9,0,20,0,1068778,2020-03-14,2.95308725748825,0.660330385123215
Montana,2020-03-21,7,0,27,0,1068778,2020-03-15,2.58013750124195,0.537995859258151
Montana,2020-03-22,7,0,34,0,1068778,2020-03-16,2.44498639131643,0.454022574773794
Montana,2020-03-23,0,0,34,0,1068778,2020-03-17,1.90645179540903,0.354019210866728
Montana,2020-03-24,17,0,51,0,1068778,2020-03-18,2.38618953306,0.359731607265153
Montana,2020-03-25,14,0,65,0,1068778,2020-03-19,2.45423303713178,0.327960684723171
Montana,2020-03-26,25,0,90,0,1068778,2020-03-20,2.71690910675906,0.303759672570075
Montana,2020-03-27,19,1,109,1,1068778,2020-03-21,2.30947095382139,0.243439613469238
Montana,2020-03-28,20,0,129,1,1068778,2020-03-22,2.04894607007656,0.20188865522261
Montana,2020-03-29,25,0,154,1,1068778,2020-03-23,1.96310608235623,0.178464189305112
Montana,2020-03-30,17,4,171,5,1068778,2020-03-24,1.8633312007029,0.158617285356488
Montana,2020-03-31,27,0,198,5,1068778,2020-03-25,1.68679386482951,0.13865360158543
Montana,2020-04-01,10,1,208,6,1068778,2020-03-26,1.42104394166384,0.118420328471986
Montana,2020-04-02,33,0,241,6,1068778,2020-03-27,1.35457853046094,0.109870827122297
Montana,2020-04-03,2,-1,243,5,1068778,2020-03-28,1.11612121225492,0.0960604192758251
Montana,2020-04-04,22,1,265,6,1068778,2020-03-29,1.08507654950847,0.0927043459281438
Montana,2020-04-05,21,0,286,6,1068778,2020-03-30,1.03508076357868,0.0897528849361708
Montana,2020-04-06,13,0,299,6,1068778,2020-03-31,0.993169280720883,0.087443679334547
Montana,2020-04-07,20,0,319,6,1068778,2020-04-01,0.938885346849253,0.0850026853253859
Montana,2020-04-08,13,0,332,6,1068778,2020-04-02,0.972026116985994,0.0869406589394338
Montana,2020-04-09,22,0,354,6,1068778,2020-04-03,0.89658261321444,0.0839726554447482
Montana,2020-04-10,11,0,365,6,1068778,2020-04-04,0.984121397063915,0.0887352380559023
Montana,2020-04-11,12,0,377,6,1068778,2020-04-05,0.917004001417328,0.0862644800524543
Montana,2020-04-12,10,0,387,6,1068778,2020-04-06,0.838330805190595,0.0830071186961125
Montana,2020-04-13,7,1,394,7,1068778,2020-04-07,0.814353834806707,0.0831146402231323
Montana,2020-04-14,5,0,399,7,1068778,2020-04-08,0.717085245909951,0.079676138434439
Montana,2020-04-15,5,0,404,7,1068778,2020-04-09,0.684856737003504,0.0801564181638887
Montana,2020-04-16,11,0,415,7,1068778,2020-04-10,0.626317343939921,0.0795423822227919
Montana,2020-04-17,7,1,422,8,1068778,2020-04-11,0.638055270153623,0.0837807614912188
Montana,2020-04-18,4,2,426,10,1068778,2020-04-12,0.602416117230696,0.0851945043179791
Montana,2020-04-19,7,0,433,10,1068778,2020-04-13,0.622136853646654,0.0907479868676961
Montana,2020-04-20,0,0,433,10,1068778,2020-04-14,0.583022654210556,0.0921839757391058
Montana,2020-04-21,4,2,437,12,1068778,2020-04-15,0.627737438560206,0.10051843711098
Montana,2020-04-22,2,2,439,14,1068778,2020-04-16,0.639435987260191,0.106572664543365
Montana,2020-04-23,3,0,442,14,1068778,2020-04-17,0.544631180951636,0.102925618646389
Montana,2020-04-24,2,0,444,14,1068778,2020-04-18,0.496323025710509,0.103490504889061
Montana,2020-04-25,1,0,445,14,1068778,2020-04-19,0.488603151296833,0.109254986032033
Montana,2020-04-26,3,0,448,14,1068778,2020-04-20,0.445844847571288,0.111461211892822
Montana,2020-04-27,1,0,449,14,1068778,2020-04-21,0.544537356371399,0.13206970808317
Montana,2020-04-28,2,1,451,15,1068778,2020-04-22,0.548081207688209,0.141513959316379
Montana,2020-04-29,0,1,451,16,1068778,2020-04-23,0.534268978287452,0.148179553546551
Montana,2020-04-30,2,0,453,16,1068778,2020-04-24,0.556744770477859,0.160718371552654
Montana,2020-05-01,0,0,453,16,1068778,2020-04-25,0.523586404247722,0.165572558932046
Montana,2020-05-02,2,0,455,16,1068778,2020-04-26,0.651828232379665,0.19653360677854
Montana,2020-05-03,0,0,455,16,1068778,2020-04-27,0.529863846264634,0.187335159399654
Montana,2020-05-04,2,0,457,16,1068778,2020-04-28,0.667141660505633,0.222380553501878
Montana,2020-05-05,-1,0,456,16,1068778,2020-04-29,0.580563347553152,0.2194323197064
Montana,2020-05-06,0,0,456,16,1068778,2020-04-30,0.645857860003366,0.244111325695039
Montana,2020-05-07,0,0,456,16,1068778,2020-05-01,0.516231576181405,0.230865779294697
Montana,2020-05-08,2,0,458,16,1068778,2020-05-02,0.817853515487315,0.309119572979907
Montana,2020-05-09,0,0,458,16,1068778,2020-05-03,0.646326930378482,0.289046190403012
Montana,2020-05-10,0,0,458,16,1068778,2020-05-04,0.704826404656342,0.315207950629671
Nebraska,2020-03-08,0,0,1,0,1934408,2020-03-02,3.66070465155515,2.58850908303578
Nebraska,2020-03-09,2,0,3,0,1934408,2020-03-03,5.64340827261365,2.82170413630682
Nebraska,2020-03-10,0,0,3,0,1934408,2020-03-04,3.66565877386782,1.83282938693391
Nebraska,2020-03-11,2,0,5,0,1934408,2020-03-05,3.71449987594901,1.51643822428441
Nebraska,2020-03-12,5,0,10,0,1934408,2020-03-06,4.84694967198855,1.46141031270202
Nebraska,2020-03-13,4,0,14,0,1934408,2020-03-07,3.83706210492423,1.02549798345715
Nebraska,2020-03-14,4,0,18,0,1934408,2020-03-08,3.17611455428272,0.748617379719534
Nebraska,2020-03-15,-1,0,17,0,1934408,2020-03-09,2.23324216563306,0.526380226450289
Nebraska,2020-03-16,1,0,18,0,1934408,2020-03-10,1.64544996512098,0.39908023575663
Nebraska,2020-03-17,5,0,23,0,1934408,2020-03-11,1.84744735838105,0.39387710023612
Nebraska,2020-03-18,1,0,24,0,1934408,2020-03-12,1.54119901645374,0.336317197804321
Nebraska,2020-03-19,5,0,29,0,1934408,2020-03-13,1.36559108802338,0.297996406153534
Nebraska,2020-03-20,8,0,37,0,1934408,2020-03-14,1.50817336956044,0.301634673912087
Nebraska,2020-03-21,1,0,38,0,1934408,2020-03-15,1.22238611639695,0.260613595678983
Nebraska,2020-03-22,13,0,51,0,1934408,2020-03-16,1.82781792259233,0.308957618829589
Nebraska,2020-03-23,0,0,51,0,1934408,2020-03-17,1.59246312388459,0.273105172637827
Nebraska,2020-03-24,15,0,66,0,1934408,2020-03-18,1.80226109265268,0.271701082662949
Nebraska,2020-03-25,5,0,71,0,1934408,2020-03-19,1.72048819654043,0.248331080852548
Nebraska,2020-03-26,3,0,74,0,1934408,2020-03-20,1.42757958730349,0.210485126918827
Nebraska,2020-03-27,8,0,82,0,1934408,2020-03-21,1.28908190430073,0.19006475761398
Nebraska,2020-03-28,14,2,96,2,1934408,2020-03-22,1.55062490567533,0.201874167809613
Nebraska,2020-03-29,12,0,108,2,1934408,2020-03-23,1.396966439263,0.183430679964373
Nebraska,2020-03-30,37,0,145,2,1934408,2020-03-24,2.08634905434131,0.214054896464752
Nebraska,2020-03-31,27,1,172,3,1934408,2020-03-25,2.00940321968663,0.194256341367691
Nebraska,2020-04-01,38,1,210,4,1934408,2020-03-26,2.15421796025831,0.18206464747249
Nebraska,2020-04-02,36,1,246,5,1934408,2020-03-27,2.17538009064565,0.16539108563283
Nebraska,2020-04-03,33,1,279,6,1934408,2020-03-28,2.0070506047568,0.14263487556537
Nebraska,2020-04-04,42,0,321,6,1934408,2020-03-29,1.88043781423,0.125084862754068
Nebraska,2020-04-05,43,2,364,8,1934408,2020-03-30,1.79758514646381,0.112130280654422
Nebraska,2020-04-06,53,1,417,9,1934408,2020-03-31,1.63042508783081,0.0986778153109159
Nebraska,2020-04-07,30,1,447,10,1934408,2020-04-01,1.44063373801951,0.0867159607678098
Nebraska,2020-04-08,72,2,519,12,1934408,2020-04-02,1.4622077336158,0.0830478186434674
Nebraska,2020-04-09,49,2,568,14,1934408,2020-04-03,1.3914102525449,0.0774201374370059
Nebraska,2020-04-10,67,1,635,15,1934408,2020-04-04,1.41116586701037,0.0746868177130235
Nebraska,2020-04-11,64,2,699,17,1934408,2020-04-05,1.38013772366744,0.0708929129669842
Nebraska,2020-04-12,92,0,791,17,1934408,2020-04-06,1.43744305279246,0.0694814325029831
Nebraska,2020-04-13,23,0,814,17,1934408,2020-04-07,1.22793002726578,0.0615505706177382
Nebraska,2020-04-14,83,3,897,20,1934408,2020-04-08,1.30409147190295,0.0614072691026678
Nebraska,2020-04-15,4,0,901,20,1934408,2020-04-09,1.04788210132038,0.053544274115128
Nebraska,2020-04-16,51,1,952,21,1934408,2020-04-10,1.0193339146235,0.0519500666724986
Nebraska,2020-04-17,114,3,1066,24,1934408,2020-04-11,1.13961043048578,0.0548295324010224
Nebraska,2020-04-18,183,0,1249,24,1934408,2020-04-12,1.42573205743337,0.0607382277002045
Nebraska,2020-04-19,225,4,1474,28,1934408,2020-04-13,1.65587240057049,0.063313863662148
Nebraska,2020-04-20,174,5,1648,33,1934408,2020-04-14,1.79776118213433,0.0622140911314809
Nebraska,2020-04-21,37,0,1685,33,1934408,2020-04-15,1.46522852245285,0.0521635167075327
Nebraska,2020-04-22,128,5,1813,38,1934408,2020-04-16,1.50663245464328,0.0498622566355025
Nebraska,2020-04-23,389,9,2202,47,1934408,2020-04-17,1.87440337067425,0.0529949396253574
Nebraska,2020-04-24,222,3,2424,50,1934408,2020-04-18,1.75980353779394,0.0477369269587122
Nebraska,2020-04-25,295,0,2719,50,1934408,2020-04-19,1.62525936711549,0.0423756469253634
Nebraska,2020-04-26,311,6,3030,56,1934408,2020-04-20,1.508319810544,0.0382251438909598
Nebraska,2020-04-27,328,0,3358,56,1934408,2020-04-21,1.48485179077806,0.0358969956412874
Nebraska,2020-04-28,159,0,3517,56,1934408,2020-04-22,1.44021430551108,0.0336392177359218
Nebraska,2020-04-29,334,0,3851,56,1934408,2020-04-23,1.45921152742306,0.0323154076598735
Nebraska,2020-04-30,430,14,4281,70,1934408,2020-04-24,1.35750725214648,0.0297653155440631
Nebraska,2020-05-01,727,3,5008,73,1934408,2020-04-25,1.55413502359232,0.0305673981619189
Nebraska,2020-05-02,309,0,5317,73,1934408,2020-04-26,1.41835828365005,0.0278216453140265
Nebraska,2020-05-03,344,5,5661,78,1934408,2020-04-27,1.30228568974424,0.0253841909381974
Nebraska,2020-05-04,376,0,6037,78,1934408,2020-04-28,1.23571238918988,0.0238698672594568
Nebraska,2020-05-05,336,0,6373,78,1934408,2020-04-29,1.24762159243675,0.0233414462796495
Nebraska,2020-05-06,316,0,6689,78,1934408,2020-04-30,1.17813880907695,0.0221112739860326
Nebraska,2020-05-07,645,13,7334,91,1934408,2020-05-01,1.21270016853005,0.0219441579997625
Nebraska,2020-05-08,484,-1,7818,90,1934408,2020-05-02,1.07052089695561,0.0201913206873343
Nebraska,2020-05-09,275,0,8093,90,1934408,2020-05-03,1.02836404335339,0.0195145680757013
Nebraska,2020-05-10,78,0,8171,90,1934408,2020-05-04,0.922054557559626,0.0184006541439623
Nevada,2020-03-08,2,0,4,0,3080156,2020-03-02,4.73873265659959,2.11922566947097
Nevada,2020-03-09,0,0,4,0,3080156,2020-03-03,3.12499887669232,1.3975419835789
Nevada,2020-03-10,0,0,4,0,3080156,2020-03-04,2.22602182361764,0.99550722340142
Nevada,2020-03-11,3,0,7,0,3080156,2020-03-05,2.92854367250652,1.03539654491516
Nevada,2020-03-12,3,0,10,0,3080156,2020-03-06,2.86767753883122,0.906839261761259
Nevada,2020-03-13,8,0,18,0,3080156,2020-03-07,3.64009101973294,0.88285175066007
Nevada,2020-03-14,2,0,20,0,3080156,2020-03-08,2.83279296773309,0.649887277595853
Nevada,2020-03-15,0,0,20,0,3080156,2020-03-09,1.82272625676325,0.44207605195421
Nevada,2020-03-16,25,1,45,1,3080156,2020-03-10,3.72619003341575,0.57496360475141
Nevada,2020-03-17,10,0,55,1,3080156,2020-03-11,3.3014494729185,0.457828667613893
Nevada,2020-03-18,0,0,55,1,3080156,2020-03-12,2.09606817128441,0.299438310183488
Nevada,2020-03-19,40,0,95,1,3080156,2020-03-13,2.87613754319535,0.310141887397279
Nevada,2020-03-20,66,1,161,2,3080156,2020-03-14,3.66737086872396,0.30561423906033
Nevada,2020-03-21,0,0,161,2,3080156,2020-03-15,2.43856696179081,0.204639993529304
Nevada,2020-03-22,29,0,190,2,3080156,2020-03-16,2.16216693460779,0.165345038017903
Nevada,2020-03-23,55,2,245,4,3080156,2020-03-17,2.04478837937037,0.14422825187475
Nevada,2020-03-24,33,0,278,4,3080156,2020-03-18,1.86553324677315,0.124646183090377
Nevada,2020-03-25,45,2,323,6,3080156,2020-03-19,1.88137897025325,0.114709700339972
Nevada,2020-03-26,97,4,420,10,3080156,2020-03-20,1.93157326010953,0.10697994851353
Nevada,2020-03-27,116,0,536,10,3080156,2020-03-21,1.87154442500105,0.0965175341631642
Nevada,2020-03-28,90,0,626,10,3080156,2020-03-22,1.95549692649353,0.0905866458519541
Nevada,2020-03-29,294,5,920,15,3080156,2020-03-23,2.57358065101773,0.0951873188689082
Nevada,2020-03-30,92,0,1012,15,3080156,2020-03-24,2.11245751610117,0.076226744723291
Nevada,2020-03-31,102,11,1114,26,3080156,2020-03-25,1.82157339659534,0.0629627873558466
Nevada,2020-04-01,165,5,1279,31,3080156,2020-03-26,1.75613456566751,0.0567677684309991
Nevada,2020-04-02,184,7,1463,38,3080156,2020-03-27,1.64941851388588,0.0510482214552548
Nevada,2020-04-03,51,5,1514,43,3080156,2020-03-28,1.35107151382808,0.0431804328472527
Nevada,2020-04-04,228,3,1742,46,3080156,2020-03-29,1.40445587726999,0.0420224639502874
Nevada,2020-04-05,113,0,1855,46,3080156,2020-03-30,1.08997190956739,0.0356268463855904
Nevada,2020-04-06,98,0,1953,46,3080156,2020-03-31,1.04764204145919,0.0341340222129468
Nevada,2020-04-07,171,26,2124,72,3080156,2020-04-01,1.11233438961602,0.0349832204277422
Nevada,2020-04-08,135,0,2259,72,3080156,2020-04-02,1.05949987256428,0.0338272275710177
Nevada,2020-04-09,197,9,2456,81,3080156,2020-04-03,1.0541366175345,0.0334351832250224
Nevada,2020-04-10,266,9,2722,90,3080156,2020-04-04,1.26742708920261,0.0364510325241947
Nevada,2020-04-11,-20,12,2702,102,3080156,2020-04-05,0.989255958287296,0.0315845119886404
Nevada,2020-04-12,134,10,2836,112,3080156,2020-04-06,0.986422416449591,0.0311622690068445
Nevada,2020-04-13,154,2,2990,114,3080156,2020-04-07,1.04785657916095,0.0322150649058976
Nevada,2020-04-14,144,12,3134,126,3080156,2020-04-08,1.01590147098947,0.0316389641599102
Nevada,2020-04-15,77,5,3211,131,3080156,2020-04-09,0.952176379514916,0.0305253732967947
Nevada,2020-04-16,3,6,3214,137,3080156,2020-04-10,0.766438134732029,0.027460495943216
Nevada,2020-04-17,310,5,3524,142,3080156,2020-04-11,0.839663418699308,0.0292688268371836
Nevada,2020-04-18,102,9,3626,151,3080156,2020-04-12,0.988573339385834,0.0325040911744213
Nevada,2020-04-19,102,7,3728,158,3080156,2020-04-13,0.969846854105305,0.0324546875164347
Nevada,2020-04-20,102,1,3830,159,3080156,2020-04-14,0.916668796387578,0.031609268840951
Nevada,2020-04-21,107,4,3937,163,3080156,2020-04-15,0.888979557621599,0.0313518916778156
Nevada,2020-04-22,144,9,4081,172,3080156,2020-04-16,0.985701828633532,0.0333992323239546
Nevada,2020-04-23,127,23,4208,195,3080156,2020-04-17,1.14057629561352,0.0361586994212269
Nevada,2020-04-24,190,2,4398,197,3080156,2020-04-18,0.985394918284473,0.0333124283110393
Nevada,2020-04-25,141,8,4539,205,3080156,2020-04-19,1.01696886467491,0.0336383402391698
Nevada,2020-04-26,195,1,4734,206,3080156,2020-04-20,1.12172454473613,0.0353485405502159
Nevada,2020-04-27,-34,0,4700,206,3080156,2020-04-21,0.990503603115977,0.03292545385208
Nevada,2020-04-28,121,13,4821,219,3080156,2020-04-22,0.995242115419181,0.0328300081072506
Nevada,2020-04-29,113,11,4934,230,3080156,2020-04-23,0.96474991643821,0.0323748874092364
Nevada,2020-04-30,119,13,5053,243,3080156,2020-04-24,0.960853544009352,0.0323903663609212
Nevada,2020-05-01,195,3,5248,246,3080156,2020-04-25,0.975002215911088,0.0327743409528611
Nevada,2020-05-02,141,9,5389,255,3080156,2020-04-26,0.981957910737322,0.0330081540766456
Nevada,2020-05-03,83,3,5472,258,3080156,2020-04-27,0.861741567513572,0.0309946898840757
Nevada,2020-05-04,158,7,5630,265,3080156,2020-04-28,1.05885054355635,0.034702424929889
Nevada,2020-05-05,30,5,5660,270,3080156,2020-04-29,0.961960636335191,0.0331907952288985
Nevada,2020-05-06,81,19,5741,289,3080156,2020-04-30,0.922866673300596,0.0324663362723856
Nevada,2020-05-07,114,8,5855,297,3080156,2020-05-01,0.931189628997808,0.032860968401362
Nevada,2020-05-08,65,-3,5920,294,3080156,2020-05-02,0.79364710693584,0.0305928477483639
Nevada,2020-05-09,251,19,6171,313,3080156,2020-05-03,0.955246841304927,0.0341377370809074
Nevada,2020-05-10,-51,-3,6120,310,3080156,2020-05-04,0.877908950451262,0.0331818393807395
New Hampshire,2020-03-08,2,0,4,0,1359711,2020-03-02,2.91689734628774,1.30447614993762
New Hampshire,2020-03-09,0,0,4,0,1359711,2020-03-03,1.90909289535075,0.954546447675374
New Hampshire,2020-03-10,0,0,4,0,1359711,2020-03-04,1.20571651550309,0.696120754792084
New Hampshire,2020-03-11,1,0,5,0,1359711,2020-03-05,1.57797889313767,0.788989446568837
New Hampshire,2020-03-12,1,0,6,0,1359711,2020-03-06,1.93660982774714,0.866078244147355
New Hampshire,2020-03-13,0,0,6,0,1359711,2020-03-07,1.74481651250944,0.780305666047044
New Hampshire,2020-03-14,1,0,7,0,1359711,2020-03-08,1.8766116152496,0.766123483790277
New Hampshire,2020-03-15,0,0,7,0,1359711,2020-03-09,1.11837180549478,0.559185902747389
New Hampshire,2020-03-16,10,0,17,0,1359711,2020-03-10,3.7637122015216,1.00589439717961
New Hampshire,2020-03-17,9,0,26,0,1359711,2020-03-11,4.70129224551006,0.980287197883598
New Hampshire,2020-03-18,11,0,37,0,1359711,2020-03-12,4.05980675221937,0.706721643059462
New Hampshire,2020-03-19,5,0,42,0,1359711,2020-03-13,2.86216728358531,0.470537402919951
New Hampshire,2020-03-20,11,0,53,0,1359711,2020-03-14,2.63191649337123,0.379884423983123
New Hampshire,2020-03-21,8,0,61,0,1359711,2020-03-15,2.27898169598312,0.307297829197613
New Hampshire,2020-03-22,12,0,73,0,1359711,2020-03-16,2.17692859966528,0.265954157424457
New Hampshire,2020-03-23,28,1,101,1,1359711,2020-03-17,2.22743853760064,0.241599630862312
New Hampshire,2020-03-24,0,0,101,1,1359711,2020-03-18,1.6009448904837,0.183640973468322
New Hampshire,2020-03-25,7,0,108,1,1359711,2020-03-19,1.2989782210713,0.153086051455525
New Hampshire,2020-03-26,29,0,137,1,1359711,2020-03-20,1.60478104652527,0.163787279703188
New Hampshire,2020-03-27,21,0,158,1,1359711,2020-03-21,1.61159823978367,0.156532258610173
New Hampshire,2020-03-28,29,1,187,2,1359711,2020-03-22,1.70726126913155,0.15149494004379
New Hampshire,2020-03-29,27,0,214,2,1359711,2020-03-23,1.67493968601277,0.140557816077323
New Hampshire,2020-03-30,100,1,314,3,1359711,2020-03-24,2.20560014376929,0.150771721892426
New Hampshire,2020-03-31,43,0,357,3,1359711,2020-03-25,2.18953856889068,0.136579663398067
New Hampshire,2020-04-01,10,0,367,3,1359711,2020-03-26,1.77126171575402,0.109848988400788
New Hampshire,2020-04-02,112,0,479,3,1359711,2020-03-27,1.96708270101476,0.106212482350659
New Hampshire,2020-04-03,0,2,479,5,1359711,2020-03-28,1.56116477972281,0.087000311797952
New Hampshire,2020-04-04,61,2,540,7,1359711,2020-03-29,1.491733640073,0.0792847484447519
New Hampshire,2020-04-05,81,2,621,9,1359711,2020-03-30,1.55533825347771,0.0770007175089293
New Hampshire,2020-04-06,94,0,715,9,1359711,2020-03-31,1.37701072096008,0.0686790525038989
New Hampshire,2020-04-07,0,0,715,9,1359711,2020-04-01,1.12257224763221,0.0592470972022379
New Hampshire,2020-04-08,32,4,747,13,1359711,2020-04-02,1.13924045050265,0.0583650563324179
New Hampshire,2020-04-09,72,8,819,21,1359711,2020-04-03,0.993579166400597,0.0538053284736402
New Hampshire,2020-04-10,0,0,819,21,1359711,2020-04-04,0.982167567806585,0.0531873557629357
New Hampshire,2020-04-11,66,1,885,22,1359711,2020-04-05,1.00158117634183,0.0538453376238058
New Hampshire,2020-04-12,44,1,929,23,1359711,2020-04-06,0.896174431921211,0.0509815821946729
New Hampshire,2020-04-13,56,0,985,23,1359711,2020-04-07,0.796865916487903,0.0484061571233894
New Hampshire,2020-04-14,-63,2,922,25,1359711,2020-04-08,0.82820834725099,0.0503100742024805
New Hampshire,2020-04-15,217,7,1139,32,1359711,2020-04-09,1.4566666268455,0.0682146647454031
New Hampshire,2020-04-16,0,0,1139,32,1359711,2020-04-10,1.17619147782971,0.0600222700102678
New Hampshire,2020-04-17,148,5,1287,37,1359711,2020-04-11,1.52393762712929,0.0660710754708371
New Hampshire,2020-04-18,55,1,1342,38,1359711,2020-04-12,1.38256211585216,0.0605711460321653
New Hampshire,2020-04-19,48,0,1390,38,1359711,2020-04-13,1.26882841549407,0.0553762119801188
New Hampshire,2020-04-20,57,4,1447,42,1359711,2020-04-14,1.193449826506,0.0520368852872069
New Hampshire,2020-04-21,43,0,1490,42,1359711,2020-04-15,1.23263907532693,0.0516749181955293
New Hampshire,2020-04-22,98,6,1588,48,1359711,2020-04-16,0.931654273827019,0.0439186036496343
New Hampshire,2020-04-23,82,3,1670,51,1359711,2020-04-17,1.08861866873149,0.0471976050333576
New Hampshire,2020-04-24,50,2,1720,53,1359711,2020-04-18,0.886525089211268,0.0425545660500431
New Hampshire,2020-04-25,77,0,1797,53,1359711,2020-04-19,0.936065011615201,0.0438352604298426
New Hampshire,2020-04-26,67,7,1864,60,1359711,2020-04-20,0.996637274945765,0.0457288543668879
New Hampshire,2020-04-27,74,0,1938,60,1359711,2020-04-21,1.03850736581691,0.0468195278567785
New Hampshire,2020-04-28,72,0,2010,60,1359711,2020-04-22,1.0943541258195,0.0479445247384484
New Hampshire,2020-04-29,48,0,2058,60,1359711,2020-04-23,0.97392017225786,0.0448758727284931
New Hampshire,2020-04-30,88,12,2146,72,1359711,2020-04-24,0.981084158678176,0.0449207577723865
New Hampshire,2020-05-01,164,9,2310,81,1359711,2020-04-25,1.22359672976738,0.0503320439503402
New Hampshire,2020-05-02,119,3,2429,84,1359711,2020-04-26,1.27582077693093,0.0507093233409254
New Hampshire,2020-05-03,89,2,2518,86,1359711,2020-04-27,1.24763896500003,0.0487492883015007
New Hampshire,2020-05-04,70,0,2588,86,1359711,2020-04-28,1.17403259022803,0.0460139650697497
New Hampshire,2020-05-05,48,6,2636,92,1359711,2020-04-29,1.08335745129784,0.0432651291362306
New Hampshire,2020-05-06,105,0,2741,92,1359711,2020-04-30,1.15270351564434,0.0440747204961205
New Hampshire,2020-05-07,102,22,2843,114,1359711,2020-05-01,1.14621280303938,0.0433847944170142
New Hampshire,2020-05-08,104,7,2947,121,1359711,2020-05-02,1.01393091940939,0.0401419095041979
New Hampshire,2020-05-09,64,10,3011,131,1359711,2020-05-03,0.913342151572416,0.0378267669538382
New Hampshire,2020-05-10,60,2,3071,133,1359711,2020-05-04,0.878140530539355,0.0373086161150298
New Jersey,2020-03-08,1,0,5,0,8882190,2020-03-02,4.05974835252115,1.65738532463024
New Jersey,2020-03-09,0,0,5,0,8882190,2020-03-03,2.62628915199003,1.07217805656372
New Jersey,2020-03-10,10,1,15,1,8882190,2020-03-04,5.31713853320985,1.32928463330246
New Jersey,2020-03-11,8,0,23,1,8882190,2020-03-05,4.94302982856178,1.00899173861111
New Jersey,2020-03-12,6,0,29,1,8882190,2020-03-06,3.30673249659854,0.624913702729676
New Jersey,2020-03-13,20,0,49,1,8882190,2020-03-07,3.79458698646329,0.547701454524508
New Jersey,2020-03-14,20,0,69,1,8882190,2020-03-08,3.4977795270738,0.430546897104499
New Jersey,2020-03-15,3,1,72,2,8882190,2020-03-09,2.40681964101107,0.291869752991171
New Jersey,2020-03-16,104,0,176,2,8882190,2020-03-10,4.56287299553609,0.347915804214252
New Jersey,2020-03-17,74,1,250,3,8882190,2020-03-11,4.02965489405075,0.262308191142507
New Jersey,2020-03-18,147,2,397,5,8882190,2020-03-12,3.95199113160218,0.204079944494062
New Jersey,2020-03-19,344,4,741,9,8882190,2020-03-13,4.82235472867804,0.180598603873848
New Jersey,2020-03-20,149,2,890,11,8882190,2020-03-14,3.39375087140305,0.116956378661782
New Jersey,2020-03-21,437,5,1327,16,8882190,2020-03-15,3.3111216339983,0.0933173225970885
New Jersey,2020-03-22,587,4,1914,20,8882190,2020-03-16,3.35655178950285,0.0781863041948797
New Jersey,2020-03-23,930,7,2844,27,8882190,2020-03-17,3.33071872327995,0.0644708908834287
New Jersey,2020-03-24,831,17,3675,44,8882190,2020-03-18,2.93440099433805,0.0501332410193064
New Jersey,2020-03-25,727,18,4402,62,8882190,2020-03-19,2.44414441623757,0.0386163650074259
New Jersey,2020-03-26,2474,19,6876,81,8882190,2020-03-20,2.84281401095876,0.0362915712737656
New Jersey,2020-03-27,1949,27,8825,108,8882190,2020-03-21,2.74160618510357,0.0307754379321251
New Jersey,2020-03-28,2299,32,11124,140,8882190,2020-03-22,2.49039866477806,0.0251593928977367
New Jersey,2020-03-29,2262,21,13386,161,8882190,2020-03-23,2.21872003227487,0.0207140017086132
New Jersey,2020-03-30,3250,37,16636,198,8882190,2020-03-24,2.10942428045886,0.017961167895306
New Jersey,2020-03-31,2060,69,18696,267,8882190,2020-03-25,1.8621958518362,0.0151936275492888
New Jersey,2020-04-01,3559,88,22255,355,8882190,2020-03-26,1.85021544878925,0.0138469631885519
New Jersey,2020-04-02,3335,182,25590,537,8882190,2020-03-27,1.64842333777121,0.0120496335300203
New Jersey,2020-04-03,4305,109,29895,646,8882190,2020-03-28,1.61084291887775,0.0110971285960445
New Jersey,2020-04-04,4229,200,34124,846,8882190,2020-03-29,1.55543992330515,0.0102560441746179
New Jersey,2020-04-05,3381,71,37505,917,8882190,2020-03-30,1.45300417592259,0.00935574143576851
New Jersey,2020-04-06,3585,86,41090,1003,8882190,2020-03-31,1.33369157067042,0.008528478770575
New Jersey,2020-04-07,3326,229,44416,1232,8882190,2020-04-01,1.29791903493028,0.00809289073791766
New Jersey,2020-04-08,3021,272,47437,1504,8882190,2020-04-02,1.19156866042317,0.00750871014032083
New Jersey,2020-04-09,3590,205,51027,1709,8882190,2020-04-03,1.14565006465412,0.00718307667779512
New Jersey,2020-04-10,3561,223,54588,1932,8882190,2020-04-04,1.07471125029493,0.00683905463647313
New Jersey,2020-04-11,3563,251,58151,2183,8882190,2020-04-05,1.02282410888567,0.0065984532572884
New Jersey,2020-04-12,3699,167,61850,2350,8882190,2020-04-06,1.02709717656392,0.00658260395728939
New Jersey,2020-04-13,2734,93,64584,2443,8882190,2020-04-07,0.986128768317352,0.00643347924128427
New Jersey,2020-04-14,4240,362,68824,2805,8882190,2020-04-08,1.02370110793697,0.00655236647537388
New Jersey,2020-04-15,2206,351,71030,3156,8882190,2020-04-09,0.9881911384402,0.00643339426406281
New Jersey,2020-04-16,4287,362,75317,3518,8882190,2020-04-10,1.01626902537349,0.00652057646341486
New Jersey,2020-04-17,3150,322,78467,3840,8882190,2020-04-11,0.998491103179422,0.00646140611440177
New Jersey,2020-04-18,2953,230,81420,4070,8882190,2020-04-12,0.971381910896667,0.00636783527065999
New Jersey,2020-04-19,3881,292,85301,4362,8882190,2020-04-13,0.983016408746063,0.00641905097447659
New Jersey,2020-04-20,3421,134,88722,4496,8882190,2020-04-14,1.0170321985725,0.0065459858961909
New Jersey,2020-04-21,3665,257,92387,4753,8882190,2020-04-15,0.992013672700062,0.00646238980884111
New Jersey,2020-04-22,3527,397,95914,5150,8882190,2020-04-16,1.04671355871721,0.00663527653346911
New Jersey,2020-04-23,4111,276,100025,5426,8882190,2020-04-17,1.03411431663378,0.00657871338662981
New Jersey,2020-04-24,2171,257,102196,5683,8882190,2020-04-18,0.983949779165893,0.00638739925760459
New Jersey,2020-04-25,3302,231,105498,5914,8882190,2020-04-19,0.997615516868873,0.00642900808848201
New Jersey,2020-04-26,3540,24,109038,5938,8882190,2020-04-20,0.985766795026601,0.00639811618612785
New Jersey,2020-04-27,2150,106,111188,6044,8882190,2020-04-21,0.934733599978934,0.00623613217484523
New Jersey,2020-04-28,2668,398,113856,6442,8882190,2020-04-22,0.902249134620127,0.00615758551557276
New Jersey,2020-04-29,2509,329,116365,6771,8882190,2020-04-23,0.876421606047267,0.00612837290051033
New Jersey,2020-04-30,2287,457,118652,7228,8882190,2020-04-24,0.819195075468603,0.00600211370180659
New Jersey,2020-05-01,2538,310,121190,7538,8882190,2020-04-25,0.86603494129493,0.00628370467439764
New Jersey,2020-05-02,2527,204,123717,7742,8882190,2020-04-26,0.861081876538155,0.00637925940055637
New Jersey,2020-05-03,3027,129,126744,7871,8882190,2020-04-27,0.862895830567066,0.00648464008954873
New Jersey,2020-05-04,1525,39,128269,7910,8882190,2020-04-28,0.859179888970486,0.00657377361699193
New Jersey,2020-05-05,2324,334,130593,8244,8882190,2020-04-29,0.869067668129829,0.00671740930357379
New Jersey,2020-05-06,1297,305,131890,8549,8882190,2020-04-30,0.831444309305057,0.00667272726541086
New Jersey,2020-05-07,2101,258,133991,8807,8882190,2020-05-01,0.850589981590172,0.00686764097921537
New Jersey,2020-05-08,1849,153,135840,8960,8882190,2020-05-02,0.842655537084168,0.00696171827999724
New Jersey,2020-05-09,1557,156,137397,9116,8882190,2020-05-03,0.814919410260022,0.00696715930385796
New Jersey,2020-05-10,1357,140,138754,9256,8882190,2020-05-04,0.744611223983296,0.00679422609213025
New Mexico,2020-03-08,0,0,0,0,2096829,2020-03-02,5,5
New Mexico,2020-03-09,0,0,0,0,2096829,2020-03-03,5,5
New Mexico,2020-03-10,0,0,0,0,2096829,2020-03-04,5,5
New Mexico,2020-03-11,3,0,3,0,2096829,2020-03-05,20,10
New Mexico,2020-03-12,2,0,5,0,2096829,2020-03-06,10.1606814002366,4.14808081159457
New Mexico,2020-03-13,5,0,10,0,2096829,2020-03-07,7.33641582470579,2.21201259968862
New Mexico,2020-03-14,3,0,13,0,2096829,2020-03-08,4.56038977774782,1.21881543560561
New Mexico,2020-03-15,0,0,13,0,2096829,2020-03-09,2.67562970940533,0.715092119033447
New Mexico,2020-03-16,8,0,21,0,2096829,2020-03-10,3.0502433110019,0.650314058964515
New Mexico,2020-03-17,2,0,23,0,2096829,2020-03-11,2.46357918764913,0.502875995890055
New Mexico,2020-03-18,5,0,28,0,2096829,2020-03-12,2.02336886054302,0.396815280888648
New Mexico,2020-03-19,7,0,35,0,2096829,2020-03-13,1.97673278195409,0.355031688329091
New Mexico,2020-03-20,7,0,42,0,2096829,2020-03-14,1.76483565253105,0.30721845353965
New Mexico,2020-03-21,13,0,55,0,2096829,2020-03-15,1.97091128575693,0.300561153330327
New Mexico,2020-03-22,2,0,57,0,2096829,2020-03-16,1.75101662986416,0.261026147607256
New Mexico,2020-03-23,26,0,83,0,2096829,2020-03-17,2.09577478675883,0.264042804274443
New Mexico,2020-03-24,17,0,100,0,2096829,2020-03-18,2.17164076998585,0.245889897026707
New Mexico,2020-03-25,13,1,113,1,2096829,2020-03-19,1.93685457743694,0.208856400376799
New Mexico,2020-03-26,0,0,113,1,2096829,2020-03-20,1.47403658708122,0.165842072964737
New Mexico,2020-03-27,23,0,136,1,2096829,2020-03-21,1.56926587666405,0.161003281812325
New Mexico,2020-03-28,72,0,208,1,2096829,2020-03-22,2.29816334738528,0.18519128004045
New Mexico,2020-03-29,29,1,237,2,2096829,2020-03-23,2.22229267944258,0.16518171398776
New Mexico,2020-03-30,0,0,237,2,2096829,2020-03-24,1.50786764714828,0.121114843961623
New Mexico,2020-03-31,78,2,315,4,2096829,2020-03-25,1.82052887358799,0.123871300063734
New Mexico,2020-04-01,12,1,327,5,2096829,2020-03-26,1.5876179332927,0.108274644374743
New Mexico,2020-04-02,46,1,373,6,2096829,2020-03-27,1.68257665019913,0.104148880022513
New Mexico,2020-04-03,117,4,490,10,2096829,2020-03-28,2.01945515132034,0.107181550706336
New Mexico,2020-04-04,16,1,506,11,2096829,2020-03-29,1.43059583938564,0.0827334935525494
New Mexico,2020-04-05,118,1,624,12,2096829,2020-03-30,1.63163130431118,0.0828335293872161
New Mexico,2020-04-06,62,0,686,12,2096829,2020-03-31,1.7019985035129,0.0802329788935554
New Mexico,2020-04-07,108,1,794,13,2096829,2020-04-01,1.58423448903259,0.0723100805017351
New Mexico,2020-04-08,27,0,821,13,2096829,2020-04-02,1.44218918344973,0.0648215832751858
New Mexico,2020-04-09,44,3,865,16,2096829,2020-04-03,1.30088478453955,0.0585889040759816
New Mexico,2020-04-10,216,1,1081,17,2096829,2020-04-04,1.45329903135885,0.0597302222518131
New Mexico,2020-04-11,10,2,1091,19,2096829,2020-04-05,1.3278246577814,0.0548519310285759
New Mexico,2020-04-12,154,7,1245,26,2096829,2020-04-06,1.30182699148047,0.0521985067690462
New Mexico,2020-04-13,17,0,1262,26,2096829,2020-04-07,1.13321678142194,0.0471764318875801
New Mexico,2020-04-14,83,5,1345,31,2096829,2020-04-08,1.03924597043628,0.0442332459699298
New Mexico,2020-04-15,139,5,1484,36,2096829,2020-04-09,1.23169399261596,0.0477989969939106
New Mexico,2020-04-16,0,0,1484,36,2096829,2020-04-10,1.11374093339657,0.0447289122547018
New Mexico,2020-04-17,113,8,1597,44,2096829,2020-04-11,0.895351342850246,0.039377507034338
New Mexico,2020-04-18,201,9,1798,53,2096829,2020-04-12,1.23258850904326,0.0463235128492148
New Mexico,2020-04-19,47,2,1845,55,2096829,2020-04-13,1.02770308525044,0.0419208832401713
New Mexico,2020-04-20,126,3,1971,58,2096829,2020-04-14,1.180793889984,0.0443144050375943
New Mexico,2020-04-21,0,0,1971,58,2096829,2020-04-15,1.01916753621815,0.040701630854256
New Mexico,2020-04-22,239,13,2210,71,2096829,2020-04-16,1.15808040135667,0.0429508246371382
New Mexico,2020-04-23,169,7,2379,78,2096829,2020-04-17,1.39914391178907,0.0467421174348692
New Mexico,2020-04-24,142,6,2521,84,2096829,2020-04-18,1.35290140628556,0.0444831242234678
New Mexico,2020-04-25,139,9,2660,93,2096829,2020-04-19,1.16613847305802,0.0396958152720329
New Mexico,2020-04-26,66,6,2726,99,2096829,2020-04-20,1.13404869141283,0.0381854057092257
New Mexico,2020-04-27,99,0,2825,99,2096829,2020-04-21,1.06714027002229,0.0364954271893726
New Mexico,2020-04-28,149,6,2974,105,2096829,2020-04-22,1.22802595911437,0.03875615561259
New Mexico,2020-04-29,239,7,3213,112,2096829,2020-04-23,1.18666231457822,0.0374507305664429
New Mexico,2020-04-30,198,11,3411,123,2096829,2020-04-24,1.16707238549687,0.036311787852792
New Mexico,2020-05-01,102,8,3513,131,2096829,2020-04-25,1.08141535159963,0.0343176788880777
New Mexico,2020-05-02,219,7,3732,138,2096829,2020-04-26,1.13984551290448,0.0347973469182949
New Mexico,2020-05-03,118,13,3850,151,2096829,2020-04-27,1.16652205082649,0.0347789680386732
New Mexico,2020-05-04,181,5,4031,156,2096829,2020-04-28,1.20946299058003,0.0348127994724762
New Mexico,2020-05-05,107,6,4138,162,2096829,2020-04-29,1.12018135360143,0.0328190024636534
New Mexico,2020-05-06,153,7,4291,169,2096829,2020-04-30,1.00293262114357,0.030532406439062
New Mexico,2020-05-07,202,3,4493,172,2096829,2020-05-01,0.996679094483908,0.030285944394524
New Mexico,2020-05-08,180,9,4673,181,2096829,2020-05-02,1.07000713159392,0.0314029582928915
New Mexico,2020-05-09,105,10,4778,191,2096829,2020-05-03,0.956612446300247,0.0295639654627723
New Mexico,2020-05-10,85,9,4863,200,2096829,2020-05-04,0.925200359515368,0.0290547280852847
New York,2020-03-08,30,0,106,0,23628065,2020-03-02,4.83596643157624,0.46751052092047
New York,2020-03-09,36,0,142,0,23628065,2020-03-03,3.59770188999386,0.301912435879162
New York,2020-03-10,8,0,150,0,23628065,2020-03-04,2.45835568437787,0.201396344863178
New York,2020-03-11,70,0,220,0,23628065,2020-03-05,2.57512776164129,0.177700697921502
New York,2020-03-12,107,1,327,1,23628065,2020-03-06,2.87589467511519,0.164673250063308
New York,2020-03-13,94,1,421,2,23628065,2020-03-07,2.71425450205382,0.137265750259004
New York,2020-03-14,192,4,613,6,23628065,2020-03-08,2.75828409293256,0.118918071335667
New York,2020-03-15,2,6,615,12,23628065,2020-03-09,1.94150089449425,0.0859711046226761
New York,2020-03-16,352,12,967,24,23628065,2020-03-10,2.52396998323926,0.0878201474639881
New York,2020-03-17,611,14,1578,38,23628065,2020-03-11,3.45493069682592,0.0913951659607919
New York,2020-03-18,1460,25,3038,63,23628065,2020-03-12,4.74264849916712,0.0893250772014546
New York,2020-03-19,2666,33,5704,96,23628065,2020-03-13,5.47351019198101,0.0746372332695295
New York,2020-03-20,2699,55,8403,151,23628065,2020-03-14,4.50544149144227,0.0504259733075845
New York,2020-03-21,3324,44,11727,195,23628065,2020-03-15,3.69642288502935,0.0350612113603832
New York,2020-03-22,4073,91,15800,286,23628065,2020-03-16,3.26502350500867,0.0264950421254176
New York,2020-03-23,5084,101,20884,387,23628065,2020-03-17,2.93461459630225,0.020793529329472
New York,2020-03-24,4797,125,25681,512,23628065,2020-03-18,2.53985442698002,0.0163592830318055
New York,2020-03-25,5160,147,30841,659,23628065,2020-03-19,2.20203173718943,0.0132059586809834
New York,2020-03-26,7036,243,37877,902,23628065,2020-03-20,2.0158683959285,0.0112385335771502
New York,2020-03-27,6999,309,44876,1211,23628065,2020-03-21,1.87311027703863,0.00980780109824475
New York,2020-03-28,7534,377,52410,1588,23628065,2020-03-22,1.75448360140775,0.00869836225611846
New York,2020-03-29,7238,428,59648,2016,23628065,2020-03-23,1.6217464842333,0.00774467358669623
New York,2020-03-30,7015,540,66663,2556,23628065,2020-03-24,1.48437645006372,0.00693755056263875
New York,2020-03-31,9170,651,75833,3207,23628065,2020-03-25,1.46111656788391,0.00652433732631917
New York,2020-04-01,8115,710,83948,3917,23628065,2020-03-26,1.40717164048024,0.00610614482531938
New York,2020-04-02,8558,813,92506,4730,23628065,2020-03-27,1.32564640336339,0.00567168493555861
New York,2020-04-03,10481,688,102987,5418,23628065,2020-03-28,1.3098641165458,0.00543367093237345
New York,2020-04-04,10846,573,113833,5991,23628065,2020-03-29,1.29671110160111,0.00523207766003663
New York,2020-04-05,9327,794,123160,6785,23628065,2020-03-30,1.2584342761409,0.00499343297957907
New York,2020-04-06,8655,1024,131815,7809,23628065,2020-03-31,1.21863449163225,0.00477426209630744
New York,2020-04-07,8060,1077,139875,8886,23628065,2020-04-01,1.14006961940949,0.004505007713709
New York,2020-04-08,11186,948,151061,9834,23628065,2020-04-02,1.15194864201379,0.00444658455684104
New York,2020-04-09,10718,944,161779,10778,23628065,2020-04-03,1.15268928124529,0.00437952613218638
New York,2020-04-10,10569,827,172348,11605,23628065,2020-04-04,1.11653774709396,0.00423948015201953
New York,2020-04-11,8678,893,181026,12498,23628065,2020-04-05,1.05136850443279,0.00405592312900408
New York,2020-04-12,8007,944,189033,13442,23628065,2020-04-06,1.01370691306986,0.00394962070114
New York,2020-04-13,6716,948,195749,14390,23628065,2020-04-07,0.978187645892649,0.00386859119309612
New York,2020-04-14,7271,871,203020,15261,23628065,2020-04-08,0.967967745825306,0.00385201494616034
New York,2020-04-15,11434,752,214454,16013,23628065,2020-04-09,0.978159041494357,0.00388494966140039
New York,2020-04-16,9237,716,223691,16729,23628065,2020-04-10,0.960961683549081,0.00386202559102295
New York,2020-04-17,6906,1026,230597,17755,23628065,2020-04-11,0.910466779131673,0.00377238612777602
New York,2020-04-18,6877,1005,237474,18760,23628065,2020-04-12,0.896187766824916,0.00377199305998973
New York,2020-04-19,5908,-178,243382,18582,23628065,2020-04-13,0.882651943153402,0.0037860793117397
New York,2020-04-20,5034,594,248416,19176,23628065,2020-04-14,0.877386934390737,0.00382311841118698
New York,2020-04-21,5103,570,253519,19746,23628065,2020-04-15,0.864756702943786,0.00384811682189801
New York,2020-04-22,4703,457,258222,20203,23628065,2020-04-16,0.772055740877996,0.00369033119591584
New York,2020-04-23,5238,540,263460,20743,23628065,2020-04-17,0.732731025589661,0.0036742337787958
New York,2020-04-24,8130,212,271590,20955,23628065,2020-04-18,0.801535741009254,0.00395879254918238
New York,2020-04-25,10553,1054,282143,22009,23628065,2020-04-19,0.921474133965745,0.00435988639162053
New York,2020-04-26,5902,260,288045,22269,23628065,2020-04-20,0.948373548453957,0.00448746035664115
New York,2020-04-27,3951,399,291996,22668,23628065,2020-04-21,0.937394575072782,0.00449028431239261
New York,2020-04-28,3110,244,295106,22912,23628065,2020-04-22,0.906130723612874,0.00444331229469597
New York,2020-04-29,4585,565,299691,23477,23628065,2020-04-23,0.920303384988847,0.0045192253904067
New York,2020-04-30,4681,110,304372,23587,23628065,2020-04-24,0.926000270431073,0.00457804914595759
New York,2020-05-01,3942,452,308314,24039,23628065,2020-04-25,0.845503193623925,0.00441198828007042
New York,2020-05-02,4663,159,312977,24198,23628065,2020-04-26,0.729591463133169,0.00415487313284266
New York,2020-05-03,3438,510,316415,24708,23628065,2020-04-27,0.707152441165916,0.00419832179045669
New York,2020-05-04,2538,291,318953,24999,23628065,2020-04-28,0.719041554357651,0.00437935503629325
New York,2020-05-05,2239,125,321192,25124,23628065,2020-04-29,0.744475546077355,0.00460933600501682
New York,2020-05-06,2786,499,323978,25623,23628065,2020-04-30,0.737823442829862,0.00473430870204436
New York,2020-05-07,3491,521,327469,26144,23628065,2020-05-01,0.745426209967527,0.00490475671488225
New York,2020-05-08,2938,99,330407,26243,23628065,2020-05-02,0.757512421225672,0.00509627181729323
New York,2020-05-09,2715,369,333122,26612,23628065,2020-05-03,0.731850931110459,0.00515618172059817
New York,2020-05-10,2273,29,335395,26641,23628065,2020-05-04,0.73219693155307,0.0053145727935025
North Carolina,2020-03-08,0,0,2,0,10488084,2020-03-02,2.36416199331914,1.36494956325069
North Carolina,2020-03-09,0,0,2,0,10488084,2020-03-03,1.99955210324317,1.15444194506613
North Carolina,2020-03-10,5,0,7,0,10488084,2020-03-04,4.18105549645614,1.58029043734038
North Carolina,2020-03-11,0,0,7,0,10488084,2020-03-05,3.01001583409114,1.13767904848169
North Carolina,2020-03-12,8,0,15,0,10488084,2020-03-06,4.56141507304441,1.17775230753603
North Carolina,2020-03-13,2,0,17,0,10488084,2020-03-07,3.16618332616142,0.791545831540355
North Carolina,2020-03-14,8,0,25,0,10488084,2020-03-08,3.21857741614259,0.656989363932905
North Carolina,2020-03-15,7,0,32,0,10488084,2020-03-09,2.97434636719991,0.534208377613181
North Carolina,2020-03-16,7,0,39,0,10488084,2020-03-10,2.61903496994039,0.424863574814894
North Carolina,2020-03-17,25,0,64,0,10488084,2020-03-11,3.00208834840143,0.394193512158328
North Carolina,2020-03-18,28,0,92,0,10488084,2020-03-12,3.26166399617681,0.351714273965554
North Carolina,2020-03-19,44,0,136,0,10488084,2020-03-13,3.23827256183498,0.293179422274748
North Carolina,2020-03-20,53,0,189,0,10488084,2020-03-14,3.19354731823052,0.242800906495929
North Carolina,2020-03-21,67,0,256,0,10488084,2020-03-15,2.99476646876066,0.196616051130435
North Carolina,2020-03-22,49,0,305,0,10488084,2020-03-16,2.52089691927603,0.152292952394263
North Carolina,2020-03-23,48,0,353,0,10488084,2020-03-17,2.1783511369904,0.122736182114676
North Carolina,2020-03-24,142,0,495,0,10488084,2020-03-18,2.37492333964397,0.114263552454014
North Carolina,2020-03-25,95,2,590,2,10488084,2020-03-19,2.16947124422061,0.0971188710252477
North Carolina,2020-03-26,148,1,738,3,10488084,2020-03-20,2.08844418705529,0.0850480219672335
North Carolina,2020-03-27,149,1,887,4,10488084,2020-03-21,1.97275370843806,0.0746163980542643
North Carolina,2020-03-28,133,1,1020,5,10488084,2020-03-22,1.78560809846106,0.0645587970473096
North Carolina,2020-03-29,171,2,1191,7,10488084,2020-03-23,1.75970477130477,0.0590851036433976
North Carolina,2020-03-30,122,0,1313,7,10488084,2020-03-24,1.64387908924384,0.0530283577175431
North Carolina,2020-03-31,222,5,1535,12,10488084,2020-03-25,1.55563127593262,0.0482149034347039
North Carolina,2020-04-01,140,2,1675,14,10488084,2020-03-26,1.44430257283326,0.0438271542454755
North Carolina,2020-04-02,302,7,1977,21,10488084,2020-03-27,1.49501736419434,0.0424556402199515
North Carolina,2020-04-03,274,6,2251,27,10488084,2020-03-28,1.49501428343571,0.0404649507605812
North Carolina,2020-04-04,235,7,2486,34,10488084,2020-03-29,1.45194975626824,0.0379084939818188
North Carolina,2020-04-05,163,4,2649,38,10488084,2020-03-30,1.31254748510587,0.0343627077283611
North Carolina,2020-04-06,313,7,2962,45,10488084,2020-03-31,1.37652693527646,0.0338877505672782
North Carolina,2020-04-07,337,8,3299,53,10488084,2020-04-01,1.37030881792187,0.032617156510836
North Carolina,2020-04-08,200,13,3499,66,10488084,2020-04-02,1.31034857197858,0.030672940018237
North Carolina,2020-04-09,237,10,3736,76,10488084,2020-04-03,1.17892861650301,0.028101608280667
North Carolina,2020-04-10,229,7,3965,83,10488084,2020-04-04,1.09461555156584,0.0264319711627963
North Carolina,2020-04-11,389,6,4354,89,10488084,2020-04-05,1.16178735478891,0.0268733615126092
North Carolina,2020-04-12,216,0,4570,89,10488084,2020-04-06,1.16133874571289,0.0264900162047826
North Carolina,2020-04-13,316,5,4886,94,10488084,2020-04-07,1.12253147162978,0.0255848667202031
North Carolina,2020-04-14,227,18,5113,112,10488084,2020-04-08,1.02743146674178,0.0241165149094567
North Carolina,2020-04-15,227,18,5340,130,10488084,2020-04-09,1.02824364110289,0.0239580363486501
North Carolina,2020-04-16,299,20,5639,150,10488084,2020-04-10,1.05743464334267,0.0242337187064447
North Carolina,2020-04-17,406,27,6045,177,10488084,2020-04-11,1.14419329417119,0.0250820689882541
North Carolina,2020-04-18,283,10,6328,187,10488084,2020-04-12,1.06024505377292,0.0238573776403315
North Carolina,2020-04-19,273,13,6601,200,10488084,2020-04-13,1.06778018173897,0.0236875423722899
North Carolina,2020-04-20,294,18,6895,218,10488084,2020-04-14,1.04246374373364,0.0232521400823138
North Carolina,2020-04-21,239,27,7134,245,10488084,2020-04-15,1.03645670655988,0.0230494512527499
North Carolina,2020-04-22,361,20,7495,265,10488084,2020-04-16,1.0961222092122,0.0236066629372228
North Carolina,2020-04-23,325,16,7820,281,10488084,2020-04-17,1.09216689555067,0.0233809221286514
North Carolina,2020-04-24,470,13,8290,294,10488084,2020-04-18,1.10079187212024,0.0232273860544705
North Carolina,2020-04-25,478,11,8768,305,10488084,2020-04-19,1.17148233161221,0.0237111082481313
North Carolina,2020-04-26,229,19,8997,324,10488084,2020-04-20,1.11529441200582,0.0227800938639487
North Carolina,2020-04-27,431,16,9428,340,10488084,2020-04-21,1.14360561875767,0.0227181506527739
North Carolina,2020-04-28,327,23,9755,363,10488084,2020-04-22,1.15077425688396,0.0224736593871525
North Carolina,2020-04-29,425,19,10180,382,10488084,2020-04-23,1.14141077580088,0.0220236331391347
North Carolina,2020-04-30,574,24,10754,406,10488084,2020-04-24,1.20873609011466,0.0223114315551336
North Carolina,2020-05-01,316,13,11070,419,10488084,2020-04-25,1.10162615682726,0.020889774156165
North Carolina,2020-05-02,518,12,11588,431,10488084,2020-04-26,1.08240397281147,0.0203792329912663
North Carolina,2020-05-03,182,3,11770,434,10488084,2020-04-27,1.04494834139299,0.0198399965638948
North Carolina,2020-05-04,201,8,11971,442,10488084,2020-04-28,0.945832157620982,0.0187523423106133
North Carolina,2020-05-05,539,30,12510,472,10488084,2020-04-29,1.02816306985778,0.0195849466998227
North Carolina,2020-05-06,543,20,13053,492,10488084,2020-04-30,1.07480216066218,0.0200486506795945
North Carolina,2020-05-07,487,21,13540,513,10488084,2020-05-01,1.02859338332941,0.0194838708398105
North Carolina,2020-05-08,466,17,14006,530,10488084,2020-05-02,1.07233711889853,0.0197869732236202
North Carolina,2020-05-09,472,21,14478,551,10488084,2020-05-03,1.04362060140884,0.0194096899392242
North Carolina,2020-05-10,460,13,14938,564,10488084,2020-05-04,1.12959119542491,0.0200659709432744
North Dakota,2020-03-08,0,0,0,0,762062,2020-03-02,5,5
North Dakota,2020-03-09,0,0,0,0,762062,2020-03-03,5,5
North Dakota,2020-03-10,0,0,0,0,762062,2020-03-04,5,5
North Dakota,2020-03-11,0,0,0,0,762062,2020-03-05,5,5
North Dakota,2020-03-12,1,0,1,0,762062,2020-03-06,10,7.07106781186548
North Dakota,2020-03-13,0,0,1,0,762062,2020-03-07,6.05747589181412,4.2832822799758
North Dakota,2020-03-14,0,0,1,0,762062,2020-03-08,3.66070465155515,2.58850908303578
North Dakota,2020-03-15,0,0,1,0,762062,2020-03-09,2.82170413630682,1.99524612928469
North Dakota,2020-03-16,0,0,1,0,762062,2020-03-10,2.40712125419537,1.70209176197981
North Dakota,2020-03-17,2,0,3,0,762062,2020-03-11,4.33554670223447,2.16777335111723
North Dakota,2020-03-18,3,0,6,0,762062,2020-03-12,5.59156560863345,2.11341314856366
North Dakota,2020-03-19,13,0,19,0,762062,2020-03-13,8.93466875795156,2.04975358999584
North Dakota,2020-03-20,7,0,26,0,762062,2020-03-14,5.53080936675829,1.0846809571947
North Dakota,2020-03-21,2,0,28,0,762062,2020-03-15,3.1225757496446,0.590111348822906
North Dakota,2020-03-22,0,0,28,0,762062,2020-03-16,2.11136273504606,0.399010051741503
North Dakota,2020-03-23,2,0,30,0,762062,2020-03-17,1.79365850629703,0.327475741453302
North Dakota,2020-03-24,6,0,36,0,762062,2020-03-18,1.73566256067661,0.297663673440863
North Dakota,2020-03-25,9,0,45,0,762062,2020-03-19,1.77791370708889,0.281112839881716
North Dakota,2020-03-26,6,0,51,0,762062,2020-03-20,1.27221933921374,0.221464960431834
North Dakota,2020-03-27,17,1,68,1,762062,2020-03-21,1.5181788654388,0.231520106488593
North Dakota,2020-03-28,26,0,94,1,762062,2020-03-22,2.19036317689332,0.267595452259568
North Dakota,2020-03-29,4,0,98,1,762062,2020-03-23,1.93997869363027,0.230233113088728
North Dakota,2020-03-30,11,1,109,2,762062,2020-03-24,1.79873476276752,0.201104660152007
North Dakota,2020-03-31,13,1,122,3,762062,2020-03-25,1.67178088956523,0.179233724720516
North Dakota,2020-04-01,20,0,142,3,762062,2020-03-26,1.64150514892656,0.165817060308372
North Dakota,2020-04-02,17,0,159,3,762062,2020-03-27,1.60959951212727,0.154171672139464
North Dakota,2020-04-03,14,0,173,3,762062,2020-03-28,1.38603120610084,0.134623251527173
North Dakota,2020-04-04,13,0,186,3,762062,2020-03-29,1.10752995588402,0.114845506471865
North Dakota,2020-04-05,21,0,207,3,762062,2020-03-30,1.2563617345321,0.119789391243606
North Dakota,2020-04-06,18,0,225,3,762062,2020-03-31,1.28681957448126,0.118966511745203
North Dakota,2020-04-07,12,1,237,4,762062,2020-04-01,1.20362453523399,0.111753732554237
North Dakota,2020-04-08,14,0,251,4,762062,2020-04-02,1.0872549788629,0.103665694731679
North Dakota,2020-04-09,18,1,269,5,762062,2020-04-03,1.06856717585891,0.101423907896515
North Dakota,2020-04-10,9,1,278,6,762062,2020-04-04,1.00635741055973,0.0977460725355133
North Dakota,2020-04-11,15,1,293,7,762062,2020-04-05,1.01992891818619,0.0981427059115135
North Dakota,2020-04-12,15,0,308,7,762062,2020-04-06,0.962457921589528,0.0952975346280308
North Dakota,2020-04-13,23,1,331,8,762062,2020-04-07,1.01420679153243,0.0980470712812326
North Dakota,2020-04-14,10,0,341,8,762062,2020-04-08,0.999209369407319,0.0975128496495461
North Dakota,2020-04-15,24,1,365,9,762062,2020-04-09,1.0941926685735,0.102033992458609
North Dakota,2020-04-16,28,0,393,9,762062,2020-04-10,1.17726530533076,0.105297810010865
North Dakota,2020-04-17,0,0,393,9,762062,2020-04-11,1.0596165724331,0.0983829288779861
North Dakota,2020-04-18,135,0,528,9,762062,2020-04-12,2.1078602613348,0.137210015961466
North Dakota,2020-04-19,57,0,585,9,762062,2020-04-13,2.16532674265994,0.129867667877705
North Dakota,2020-04-20,42,0,627,9,762062,2020-04-14,1.8516245744403,0.107442155209511
North Dakota,2020-04-21,17,4,644,13,762062,2020-04-15,1.58415465101452,0.0908575004567398
North Dakota,2020-04-22,35,1,679,14,762062,2020-04-16,1.44011550725937,0.0811413165507183
North Dakota,2020-04-23,30,1,709,15,762062,2020-04-17,1.3144994532507,0.0738296447473625
North Dakota,2020-04-24,39,0,748,15,762062,2020-04-18,1.37150028871055,0.0726893699230646
North Dakota,2020-04-25,55,1,803,16,762062,2020-04-19,0.990239998621938,0.0596054434968765
North Dakota,2020-04-26,64,1,867,17,762062,2020-04-20,0.984986412528737,0.0585513646890302
North Dakota,2020-04-27,75,2,942,19,762062,2020-04-21,1.10793885692019,0.0623264301443357
North Dakota,2020-04-28,49,0,991,19,762062,2020-04-22,1.20514972274044,0.0646028062053158
North Dakota,2020-04-29,42,0,1033,19,762062,2020-04-23,1.18532072270582,0.0629102919472617
North Dakota,2020-04-30,34,0,1067,19,762062,2020-04-24,1.14967017317955,0.0606772710126708
North Dakota,2020-05-01,40,4,1107,23,762062,2020-04-25,1.11383955872532,0.0587044992261482
North Dakota,2020-05-02,46,1,1153,24,762062,2020-04-26,1.05712312429337,0.0564250580792544
North Dakota,2020-05-03,38,1,1191,25,762062,2020-04-27,0.96263994206896,0.0533976564759895
North Dakota,2020-05-04,34,0,1225,25,762062,2020-04-28,0.841838396110444,0.0499539183833603
North Dakota,2020-05-05,41,0,1266,25,762062,2020-04-29,0.839543400562104,0.0505345742395982
North Dakota,2020-05-06,57,6,1323,31,762062,2020-04-30,0.919755235932707,0.0539170067982376
North Dakota,2020-05-07,48,0,1371,31,762062,2020-05-01,0.989922918501039,0.0566828214232818
North Dakota,2020-05-08,54,2,1425,33,762062,2020-05-02,1.04426698196284,0.0584677262639466
North Dakota,2020-05-09,39,2,1464,35,762062,2020-05-03,1.01634507187994,0.0575392091827848
North Dakota,2020-05-10,27,0,1491,35,762062,2020-05-04,0.974554738041063,0.056172401253513
Northern Mariana Islands,2020-03-08,0,0,0,0,55144,2020-03-02,5,5
Northern Mariana Islands,2020-03-09,0,0,0,0,55144,2020-03-03,5,5
Northern Mariana Islands,2020-03-10,0,0,0,0,55144,2020-03-04,5,5
Northern Mariana Islands,2020-03-11,0,0,0,0,55144,2020-03-05,5,5
Northern Mariana Islands,2020-03-12,0,0,0,0,55144,2020-03-06,5,5
Northern Mariana Islands,2020-03-13,0,0,0,0,55144,2020-03-07,5,5
Northern Mariana Islands,2020-03-14,0,0,0,0,55144,2020-03-08,5,5
Northern Mariana Islands,2020-03-15,0,0,0,0,55144,2020-03-09,5,5
Northern Mariana Islands,2020-03-16,0,0,0,0,55144,2020-03-10,5,5
Northern Mariana Islands,2020-03-17,0,0,0,0,55144,2020-03-11,5,5
Northern Mariana Islands,2020-03-18,0,0,0,0,55144,2020-03-12,5,5
Northern Mariana Islands,2020-03-19,0,0,0,0,55144,2020-03-13,5,5
Northern Mariana Islands,2020-03-20,0,0,0,0,55144,2020-03-14,5,5
Northern Mariana Islands,2020-03-21,0,0,0,0,55144,2020-03-15,5,5
Northern Mariana Islands,2020-03-22,0,0,0,0,55144,2020-03-16,5,5
Northern Mariana Islands,2020-03-23,0,0,0,0,55144,2020-03-17,5,5
Northern Mariana Islands,2020-03-24,0,0,0,0,55144,2020-03-18,5,5
Northern Mariana Islands,2020-03-25,0,0,0,0,55144,2020-03-19,5,5
Northern Mariana Islands,2020-03-26,0,0,0,0,55144,2020-03-20,5,5
Northern Mariana Islands,2020-03-27,0,0,0,0,55144,2020-03-21,5,5
Northern Mariana Islands,2020-03-28,0,0,0,0,55144,2020-03-22,5,5
Northern Mariana Islands,2020-03-29,0,0,0,0,55144,2020-03-23,5,5
Northern Mariana Islands,2020-03-30,0,0,0,0,55144,2020-03-24,5,5
Northern Mariana Islands,2020-03-31,2,0,2,0,55144,2020-03-25,15,8.66025403784439
Northern Mariana Islands,2020-04-01,4,1,6,1,55144,2020-03-26,15.2061172402075,5.74737208921156
Northern Mariana Islands,2020-04-02,0,0,6,1,55144,2020-03-27,4.95270903800586,1.87194806151792
Northern Mariana Islands,2020-04-03,2,0,8,1,55144,2020-03-28,3.45760919357269,1.15253639785756
Northern Mariana Islands,2020-04-04,0,0,8,1,55144,2020-03-29,2.39537331126605,0.798457770422016
Northern Mariana Islands,2020-04-05,0,0,8,1,55144,2020-03-30,1.85133031023405,0.617110103411351
Northern Mariana Islands,2020-04-06,0,0,8,1,55144,2020-03-31,1.58141806967611,0.527139356558703
Northern Mariana Islands,2020-04-07,0,1,8,2,55144,2020-04-01,1.10853953885433,0.418988562612967
Northern Mariana Islands,2020-04-08,3,0,11,2,55144,2020-04-02,0.919845483109172,0.375525345970226
Northern Mariana Islands,2020-04-09,0,0,11,2,55144,2020-04-03,0.950505229674978,0.388042135091771
Northern Mariana Islands,2020-04-10,0,0,11,2,55144,2020-04-04,0.66269407170308,0.33134703585154
Northern Mariana Islands,2020-04-11,0,0,11,2,55144,2020-04-05,0.718407619128309,0.359203809564155
Northern Mariana Islands,2020-04-12,0,0,11,2,55144,2020-04-06,0.80330958777922,0.40165479388961
Northern Mariana Islands,2020-04-13,0,0,11,2,55144,2020-04-07,0.881605083651818,0.440802541825909
Northern Mariana Islands,2020-04-14,0,0,11,2,55144,2020-04-08,0.951280277150598,0.475640138575299
Northern Mariana Islands,2020-04-15,2,0,13,2,55144,2020-04-09,0.758508729509135,0.43792521916478
Northern Mariana Islands,2020-04-16,0,0,13,2,55144,2020-04-10,0.824789454599531,0.476192413637804
Northern Mariana Islands,2020-04-17,0,0,13,2,55144,2020-04-11,0.914608430183062,0.528049423369292
Northern Mariana Islands,2020-04-18,1,0,14,2,55144,2020-04-12,1.3281690662866,0.664084533143299
Northern Mariana Islands,2020-04-19,0,0,14,2,55144,2020-04-13,1.36048953054772,0.680244765273859
Northern Mariana Islands,2020-04-20,0,0,14,2,55144,2020-04-14,1.33124562423383,0.665622812116914
Northern Mariana Islands,2020-04-21,0,0,14,2,55144,2020-04-15,1.31008370334632,0.655041851673159
Northern Mariana Islands,2020-04-22,0,0,14,2,55144,2020-04-16,0.647309268834882,0.457716773518051
Northern Mariana Islands,2020-04-23,0,0,14,2,55144,2020-04-17,0.700088683048587,0.495037455215616
Northern Mariana Islands,2020-04-24,0,0,14,2,55144,2020-04-18,0.817984786255901,0.578402589268976
Northern Mariana Islands,2020-04-25,0,0,14,2,55144,2020-04-19,0.468249364722424,0.468249364722424
Northern Mariana Islands,2020-04-26,0,0,14,2,55144,2020-04-20,0.564040506914229,0.564040506914229
Northern Mariana Islands,2020-04-27,0,0,14,2,55144,2020-04-21,0.723580937447073,0.723580937447073
Northern Mariana Islands,2020-04-28,0,0,14,2,55144,2020-04-22,0.918899970367475,0.918899970367475
Northern Mariana Islands,2020-04-29,0,0,14,2,55144,2020-04-23,1.15273042001437,1.15273042001437
Northern Mariana Islands,2020-04-30,0,0,14,2,55144,2020-04-24,1.42528260993045,1.42528260993045
Northern Mariana Islands,2020-05-01,0,0,14,2,55144,2020-04-25,1.73324505052195,1.73324505052195
Northern Mariana Islands,2020-05-02,0,0,14,2,55144,2020-04-26,2.06923145145161,2.06923145145161
Northern Mariana Islands,2020-05-03,0,0,14,2,55144,2020-04-27,2.42205883278258,2.42205883278258
Northern Mariana Islands,2020-05-04,0,0,14,2,55144,2020-04-28,2.77802170974892,2.77802170974892
Northern Mariana Islands,2020-05-05,0,0,14,2,55144,2020-04-29,3.12292508867614,3.12292508867614
Northern Mariana Islands,2020-05-06,1,0,15,2,55144,2020-04-30,6.88854561116451,4.87093731416725
Northern Mariana Islands,2020-05-07,0,0,15,2,55144,2020-05-01,5.02440900219529,3.55279367690702
Northern Mariana Islands,2020-05-08,0,0,15,2,55144,2020-05-02,3.34807675930424,2.36744778043711
Northern Mariana Islands,2020-05-09,1,0,16,2,55144,2020-05-03,4.01537555233764,2.31827815603958
Northern Mariana Islands,2020-05-10,0,0,16,2,55144,2020-05-04,3.03076960470657,1.74981564712908
Ohio,2020-03-08,0,0,0,0,11689100,2020-03-02,5,5
Ohio,2020-03-09,0,0,0,0,11689100,2020-03-03,5,5
Ohio,2020-03-10,3,0,3,0,11689100,2020-03-04,20,10
Ohio,2020-03-11,1,0,4,0,11689100,2020-03-05,8.46723450019719,3.78666238477447
Ohio,2020-03-12,1,0,5,0,11689100,2020-03-06,4.38212341234838,1.78899439169289
Ohio,2020-03-13,7,0,12,0,11689100,2020-03-07,5.90134398534971,1.63673833333303
Ohio,2020-03-14,14,0,26,0,11689100,2020-03-08,6.9967543851701,1.34652600924388
Ohio,2020-03-15,4,0,30,0,11689100,2020-03-09,3.99780032056934,0.718026134018593
Ohio,2020-03-16,20,0,50,0,11689100,2020-03-10,3.96605353274242,0.555358577408814
Ohio,2020-03-17,17,0,67,0,11689100,2020-03-11,3.28745382104474,0.407758462167564
Ohio,2020-03-18,22,0,89,0,11689100,2020-03-12,2.94959531211166,0.318063042332862
Ohio,2020-03-19,30,0,119,0,11689100,2020-03-13,2.83256686067452,0.264138221724116
Ohio,2020-03-20,54,3,173,3,11689100,2020-03-14,2.92110472317535,0.229503662034816
Ohio,2020-03-21,74,0,247,3,11689100,2020-03-15,2.91433856685165,0.195597597608625
Ohio,2020-03-22,109,0,356,3,11689100,2020-03-16,3.11085069341516,0.172030436435855
Ohio,2020-03-23,87,3,443,6,11689100,2020-03-17,2.66877330375638,0.134450856672641
Ohio,2020-03-24,124,2,567,8,11689100,2020-03-18,2.49585694674373,0.111506664933397
Ohio,2020-03-25,137,3,704,11,11689100,2020-03-19,2.34672558589219,0.094552268368892
Ohio,2020-03-26,164,4,868,15,11689100,2020-03-20,2.22857113928994,0.0813759122662726
Ohio,2020-03-27,269,4,1137,19,11689100,2020-03-21,2.28005683022848,0.0733976263474645
Ohio,2020-03-28,269,6,1406,25,11689100,2020-03-22,2.17950306118552,0.0639924133011163
Ohio,2020-03-29,247,4,1653,29,11689100,2020-03-23,1.9519716615428,0.0541796458766914
Ohio,2020-03-30,280,11,1933,40,11689100,2020-03-24,1.85042713128445,0.0479218047974614
Ohio,2020-03-31,266,15,2199,55,11689100,2020-03-25,1.71350591676787,0.0424026028300109
Ohio,2020-04-01,348,10,2547,65,11689100,2020-03-26,1.66877334176678,0.0388612615567025
Ohio,2020-04-02,354,16,2901,81,11689100,2020-03-27,1.60982724717583,0.0356947051987824
Ohio,2020-04-03,411,10,3312,91,11689100,2020-03-28,1.51924200472442,0.0325684817874133
Ohio,2020-04-04,427,11,3739,102,11689100,2020-03-29,1.45864388101093,0.030192484264938
Ohio,2020-04-05,304,17,4043,119,11689100,2020-03-30,1.3557460067505,0.0277260847156522
Ohio,2020-04-06,410,23,4453,142,11689100,2020-03-31,1.31811357836317,0.026252242725186
Ohio,2020-04-07,329,25,4782,167,11689100,2020-04-01,1.26159375285056,0.0248183711575969
Ohio,2020-04-08,366,26,5148,193,11689100,2020-04-02,1.19703419821739,0.0234667481209477
Ohio,2020-04-09,364,20,5512,213,11689100,2020-04-03,1.14671177832317,0.022437149776687
Ohio,2020-04-10,366,18,5878,231,11689100,2020-04-04,1.08794835615783,0.0214731296350835
Ohio,2020-04-11,372,16,6250,247,11689100,2020-04-05,1.039655179986,0.0207433790878912
Ohio,2020-04-12,354,6,6604,253,11689100,2020-04-06,1.04729236452489,0.0206908520139148
Ohio,2020-04-13,371,21,6975,274,11689100,2020-04-07,1.02189442857883,0.0203445180490816
Ohio,2020-04-14,310,50,7285,324,11689100,2020-04-08,1.00691855447119,0.0201222796996474
Ohio,2020-04-15,509,38,7794,362,11689100,2020-04-09,1.06172156618108,0.0206363872215375
Ohio,2020-04-16,620,45,8414,407,11689100,2020-04-10,1.15462326128749,0.0214297342170616
Ohio,2020-04-17,693,11,9107,418,11689100,2020-04-11,1.25176394151207,0.022025266698693
Ohio,2020-04-18,1115,33,10222,451,11689100,2020-04-12,1.4698976140426,0.0233199600679469
Ohio,2020-04-19,1380,20,11602,471,11689100,2020-04-13,1.70589809985651,0.0241274551546004
Ohio,2020-04-20,1317,38,12919,509,11689100,2020-04-14,1.78910964639857,0.0232039022806298
Ohio,2020-04-21,806,48,13725,557,11689100,2020-04-15,1.66762558336666,0.0207788687337901
Ohio,2020-04-22,392,53,14117,610,11689100,2020-04-16,1.42293905633594,0.0178932969458505
Ohio,2020-04-23,577,46,14694,656,11689100,2020-04-17,1.27530058662223,0.0160915605126528
Ohio,2020-04-24,475,34,15169,690,11689100,2020-04-18,1.15113572302712,0.0147836866020604
Ohio,2020-04-25,418,21,15587,711,11689100,2020-04-19,0.977341337760634,0.0133419999278684
Ohio,2020-04-26,385,17,15972,728,11689100,2020-04-20,0.788735697431024,0.0119300178585082
Ohio,2020-04-27,353,25,16325,753,11689100,2020-04-21,0.634642526491257,0.0108728426592934
Ohio,2020-04-28,444,46,16769,799,11689100,2020-04-22,0.609631266146405,0.0110477435401008
Ohio,2020-04-29,534,138,17303,937,11689100,2020-04-23,0.699994633232496,0.0123994858866151
Ohio,2020-04-30,724,39,18027,976,11689100,2020-04-24,0.794484451263289,0.0137594984730583
Ohio,2020-05-01,716,27,18743,1003,11689100,2020-04-25,0.901752717236035,0.0150816700958164
Ohio,2020-05-02,592,19,19335,1022,11689100,2020-04-26,0.976561523444945,0.0159493096155733
Ohio,2020-05-03,579,17,19914,1039,11689100,2020-04-27,1.03877266850449,0.0165427278737955
Ohio,2020-05-04,560,18,20474,1057,11689100,2020-04-28,1.08945538649348,0.0169116274192102
Ohio,2020-05-05,495,78,20969,1135,11689100,2020-04-29,1.085745483935,0.0167514224394705
Ohio,2020-05-06,607,90,21576,1225,11689100,2020-04-30,1.08327360635683,0.0165699387435424
Ohio,2020-05-07,555,46,22131,1271,11689100,2020-05-01,1.0215858668569,0.01594477133273
Ohio,2020-05-08,885,35,23016,1306,11689100,2020-05-02,1.05280755936641,0.0161039248672449
Ohio,2020-05-09,681,25,23697,1331,11689100,2020-05-03,1.06604469582722,0.0161392298657775
Ohio,2020-05-10,384,10,24081,1341,11689100,2020-05-04,1.00454485902299,0.0155598526607658
Oklahoma,2020-03-08,0,0,1,0,3956971,2020-03-02,6.05747589181412,4.2832822799758
Oklahoma,2020-03-09,0,0,1,0,3956971,2020-03-03,3.66070465155515,2.58850908303578
Oklahoma,2020-03-10,1,0,2,0,3956971,2020-03-04,4.23255620446024,2.44366746400534
Oklahoma,2020-03-11,0,0,2,0,3956971,2020-03-05,3.12162306547093,1.80226991715819
Oklahoma,2020-03-12,1,0,3,0,3956971,2020-03-06,3.15221599109219,1.57610799554609
Oklahoma,2020-03-13,0,0,3,0,3956971,2020-03-07,2.45322538865046,1.22661269432523
Oklahoma,2020-03-14,1,0,4,0,3956971,2020-03-08,1.97964794145888,0.989823970729438
Oklahoma,2020-03-15,0,0,4,0,3956971,2020-03-09,1.72884860270158,0.864424301350788
Oklahoma,2020-03-16,6,0,10,0,3956971,2020-03-10,3.94640842531139,1.24796392012625
Oklahoma,2020-03-17,7,0,17,0,3956971,2020-03-11,4.59703881484607,1.14925970371152
Oklahoma,2020-03-18,0,0,17,0,3956971,2020-03-12,2.8154392517866,0.70385981294665
Oklahoma,2020-03-19,27,1,44,1,3956971,2020-03-13,5.21858873023464,0.805245723149624
Oklahoma,2020-03-20,5,0,49,1,3956971,2020-03-14,3.5579152612283,0.518975279329295
Oklahoma,2020-03-21,4,0,53,1,3956971,2020-03-15,2.40188418445354,0.339677718890364
Oklahoma,2020-03-22,14,1,67,2,3956971,2020-03-16,2.32594007103244,0.290742508879054
Oklahoma,2020-03-23,14,0,81,2,3956971,2020-03-17,2.0733045295574,0.24434128205247
Oklahoma,2020-03-24,25,1,106,3,3956971,2020-03-18,2.1006108868183,0.2214238293364
Oklahoma,2020-03-25,58,2,164,5,3956971,2020-03-19,2.8333661076063,0.232901259377898
Oklahoma,2020-03-26,84,2,248,7,3956971,2020-03-20,2.9722508060078,0.20759100095414
Oklahoma,2020-03-27,74,1,322,8,3956971,2020-03-21,2.85915148583754,0.172727658077226
Oklahoma,2020-03-28,55,7,377,15,3956971,2020-03-22,2.46686531714545,0.136837067548179
Oklahoma,2020-03-29,52,1,429,16,3956971,2020-03-23,2.09174475409096,0.1097881269864
Oklahoma,2020-03-30,52,0,481,16,3956971,2020-03-24,1.85709695809752,0.0927389965211412
Oklahoma,2020-03-31,87,7,568,23,3956971,2020-03-25,1.79996863672058,0.0836516366460263
Oklahoma,2020-04-01,153,7,721,30,3956971,2020-03-26,1.85487197610151,0.0785229921779954
Oklahoma,2020-04-02,160,4,881,34,3956971,2020-03-27,1.79450968444504,0.0712690840850383
Oklahoma,2020-04-03,109,4,990,38,3956971,2020-03-28,1.61646278692163,0.0624960619566811
Oklahoma,2020-04-04,171,4,1161,42,3956971,2020-03-29,1.65985836332234,0.0592428854208022
Oklahoma,2020-04-05,93,4,1254,46,3956971,2020-03-30,1.53943568789855,0.0535638181200037
Oklahoma,2020-04-06,75,5,1329,51,3956971,2020-03-31,1.406930447803,0.0482857279666681
Oklahoma,2020-04-07,145,16,1474,67,3956971,2020-04-01,1.37102813729768,0.0455242421003512
Oklahoma,2020-04-08,52,12,1526,79,3956971,2020-04-02,1.12650915048637,0.0396795924529559
Oklahoma,2020-04-09,160,1,1686,80,3956971,2020-04-03,1.07504720696796,0.0378669228046302
Oklahoma,2020-04-10,108,8,1794,88,3956971,2020-04-04,1.05432877592723,0.0371602065888296
Oklahoma,2020-04-11,74,6,1868,94,3956971,2020-04-05,0.915027228266501,0.0343888290820477
Oklahoma,2020-04-12,102,2,1970,96,3956971,2020-04-06,0.932756853531736,0.0348344430260488
Oklahoma,2020-04-13,99,3,2069,99,3956971,2020-04-07,0.982004305937766,0.036074829578575
Oklahoma,2020-04-14,115,9,2184,108,3956971,2020-04-08,0.950324910457594,0.0356399686234815
Oklahoma,2020-04-15,79,15,2263,123,3956971,2020-04-09,0.994233271819288,0.0365982324937972
Oklahoma,2020-04-16,94,8,2357,131,3956971,2020-04-10,0.910788294572305,0.0351344212396918
Oklahoma,2020-04-17,108,5,2465,136,3956971,2020-04-11,0.921714026685044,0.0355558905061378
Oklahoma,2020-04-18,0,0,2465,136,3956971,2020-04-12,0.836723081210825,0.0342161512701829
Oklahoma,2020-04-19,102,4,2567,140,3956971,2020-04-13,0.861359609067688,0.0352236138140662
Oklahoma,2020-04-20,113,3,2680,143,3956971,2020-04-14,0.913253151942589,0.0369160706704662
Oklahoma,2020-04-21,127,21,2807,164,3956971,2020-04-15,0.954377984467776,0.0382056961712613
Oklahoma,2020-04-22,87,6,2894,170,3956971,2020-04-16,0.980153794311837,0.0389884245338631
Oklahoma,2020-04-23,123,9,3017,179,3956971,2020-04-17,1.03205322175545,0.0401422179121233
Oklahoma,2020-04-24,104,9,3121,188,3956971,2020-04-18,1.02345730580509,0.039928872392563
Oklahoma,2020-04-25,73,6,3194,194,3956971,2020-04-19,1.13010325006725,0.0418269978326015
Oklahoma,2020-04-26,60,1,3254,195,3956971,2020-04-20,1.04558265215305,0.0398624649044782
Oklahoma,2020-04-27,27,2,3281,197,3956971,2020-04-21,0.898195897465041,0.0366077318372883
Oklahoma,2020-04-28,129,10,3410,207,3956971,2020-04-22,0.910660887177451,0.0370542659919657
Oklahoma,2020-04-29,63,7,3473,214,3956971,2020-04-23,0.894933364362715,0.0371600853403118
Oklahoma,2020-04-30,145,8,3618,222,3956971,2020-04-24,0.94980855581684,0.0387113067497153
Oklahoma,2020-05-01,130,8,3748,230,3956971,2020-04-25,1.00785843636682,0.0402179299732201
Oklahoma,2020-05-02,103,8,3851,238,3956971,2020-04-26,1.05950569174446,0.0413038321639398
Oklahoma,2020-05-03,121,0,3972,238,3956971,2020-04-27,1.14768362970106,0.0428013770508165
Oklahoma,2020-05-04,72,0,4044,238,3956971,2020-04-28,1.18993019504853,0.0430501635603889
Oklahoma,2020-05-05,83,9,4127,247,3956971,2020-04-29,1.07672645262527,0.0401830743235668
Oklahoma,2020-05-06,75,6,4202,253,3956971,2020-04-30,1.0660096148205,0.0394547859640047
Oklahoma,2020-05-07,128,7,4330,260,3956971,2020-05-01,1.02676827176269,0.0384527739694377
Oklahoma,2020-05-08,94,6,4424,266,3956971,2020-05-02,0.965977397229519,0.0371255272547257
Oklahoma,2020-05-09,66,4,4490,270,3956971,2020-05-03,0.915619244780962,0.0361930285373885
Oklahoma,2020-05-10,99,2,4589,272,3956971,2020-05-04,0.897599938393935,0.0361067647653464
Oregon,2020-03-08,8,0,14,0,4217737,2020-03-02,6.44092599049735,1.72140987928633
Oregon,2020-03-09,0,0,14,0,4217737,2020-03-03,3.02488443296766,0.873208920820694
Oregon,2020-03-10,0,0,14,0,4217737,2020-03-04,1.99955359280125,0.577221402531444
Oregon,2020-03-11,5,0,19,0,4217737,2020-03-05,2.33089855589907,0.565325938151266
Oregon,2020-03-12,5,0,24,0,4217737,2020-03-06,2.46773026365078,0.526121859982765
Oregon,2020-03-13,6,0,30,0,4217737,2020-03-07,2.46123623389407,0.465129928047494
Oregon,2020-03-14,6,0,36,0,4217737,2020-03-08,2.12346097925724,0.381384850521569
Oregon,2020-03-15,0,1,36,1,4217737,2020-03-09,1.26924547036225,0.26465597554718
Oregon,2020-03-16,3,0,39,1,4217737,2020-03-10,1.29472121140306,0.253915720061796
Oregon,2020-03-17,27,0,66,1,4217737,2020-03-11,2.52398506922082,0.346696012506243
Oregon,2020-03-18,9,2,75,3,4217737,2020-03-12,2.23028236875527,0.295408116280803
Oregon,2020-03-19,13,0,88,3,4217737,2020-03-13,1.98781016608479,0.246557506364057
Oregon,2020-03-20,26,0,114,3,4217737,2020-03-14,2.1474884225056,0.232927823327201
Oregon,2020-03-21,23,1,137,4,4217737,2020-03-15,2.1116752289266,0.209087003948637
Oregon,2020-03-22,24,1,161,5,4217737,2020-03-16,2.11989057693621,0.188854862770139
Oregon,2020-03-23,30,0,191,5,4217737,2020-03-17,2.09760961650067,0.169581686473404
Oregon,2020-03-24,19,3,210,8,4217737,2020-03-18,1.62115274943859,0.134629407993337
Oregon,2020-03-25,56,2,266,10,4217737,2020-03-19,1.8461925357844,0.133237469688875
Oregon,2020-03-26,50,1,316,11,4217737,2020-03-20,1.90663341541421,0.125993882515493
Oregon,2020-03-27,100,1,416,12,4217737,2020-03-21,2.12495095179483,0.122075242548789
Oregon,2020-03-28,63,1,479,13,4217737,2020-03-22,1.97694758091506,0.106745135798204
Oregon,2020-03-29,69,0,548,13,4217737,2020-03-23,1.84155472588395,0.0934907764404981
Oregon,2020-03-30,58,3,606,16,4217737,2020-03-24,1.66912721405239,0.0818356945684797
Oregon,2020-03-31,84,2,690,18,4217737,2020-03-25,1.67499524474581,0.0763732092374871
Oregon,2020-04-01,46,1,736,19,4217737,2020-03-26,1.4384064960674,0.0662782727866815
Oregon,2020-04-02,90,2,826,21,4217737,2020-03-27,1.40343400929031,0.0620842653557292
Oregon,2020-04-03,73,1,899,22,4217737,2020-03-28,1.22320986546603,0.0556004484302739
Oregon,2020-04-04,0,0,899,22,4217737,2020-03-29,1.00088816805078,0.0487803045450317
Oregon,2020-04-05,169,5,1068,27,4217737,2020-03-30,1.21735619881058,0.053333343396198
Oregon,2020-04-06,0,0,1068,27,4217737,2020-03-31,1.05452314847464,0.0490078468321212
Oregon,2020-04-07,64,2,1132,29,4217737,2020-04-01,0.980791536694814,0.0465988121815543
Oregon,2020-04-08,49,4,1181,33,4217737,2020-04-02,0.987407140915995,0.0467550832212092
Oregon,2020-04-09,140,11,1321,44,4217737,2020-04-03,1.10290710029272,0.0495219907138872
Oregon,2020-04-10,1,0,1322,44,4217737,2020-04-04,0.931651854895325,0.0452450137649375
Oregon,2020-04-11,49,4,1371,48,4217737,2020-04-05,1.03796878858477,0.0477258557462814
Oregon,2020-04-12,156,4,1527,52,4217737,2020-04-06,1.01321664706914,0.0472414697590553
Oregon,2020-04-13,57,1,1584,53,4217737,2020-04-07,1.13171045202216,0.0497725687700122
Oregon,2020-04-14,49,2,1633,55,4217737,2020-04-08,1.07994336004627,0.0482002310443129
Oregon,2020-04-15,30,3,1663,58,4217737,2020-04-09,1.01545048505771,0.0462045969319927
Oregon,2020-04-16,73,6,1736,64,4217737,2020-04-10,0.867521106216841,0.0425337216255122
Oregon,2020-04-17,49,6,1785,70,4217737,2020-04-11,0.9841558233243,0.0456882871077802
Oregon,2020-04-18,59,2,1844,72,4217737,2020-04-12,1.02213801339628,0.0469483538494864
Oregon,2020-04-19,66,2,1910,74,4217737,2020-04-13,0.825978958266247,0.0421505622089147
Oregon,2020-04-20,47,1,1957,75,4217737,2020-04-14,0.821527430302747,0.0424801721202791
Oregon,2020-04-21,47,3,2004,78,4217737,2020-04-15,0.853129018808415,0.0442326790938545
Oregon,2020-04-22,55,0,2059,78,4217737,2020-04-16,0.944869323215745,0.0474216319702928
Oregon,2020-04-23,68,5,2127,83,4217737,2020-04-17,0.953192559686172,0.0481434944807611
Oregon,2020-04-24,50,3,2177,86,4217737,2020-04-18,0.96593770938678,0.0487251119589077
Oregon,2020-04-25,76,1,2253,87,4217737,2020-04-19,1.01712439821528,0.0502321935795816
Oregon,2020-04-26,58,5,2311,92,4217737,2020-04-20,0.998504975923502,0.049800901781681
Oregon,2020-04-27,43,0,2354,92,4217737,2020-04-21,0.987102408042887,0.0494789728438107
Oregon,2020-04-28,31,7,2385,99,4217737,2020-04-22,0.949817539570266,0.0485968929714635
Oregon,2020-04-29,61,2,2446,101,4217737,2020-04-23,0.972768711210709,0.0493848490244883
Oregon,2020-04-30,64,2,2510,103,4217737,2020-04-24,0.971529015395445,0.0495781324589038
Oregon,2020-05-01,69,1,2579,104,4217737,2020-04-25,1.02614727191383,0.0511160365268463
Oregon,2020-05-02,56,5,2635,109,4217737,2020-04-26,0.974962345504142,0.0498182486501324
Oregon,2020-05-03,45,0,2680,109,4217737,2020-04-27,0.94253223353859,0.0489999175746478
Oregon,2020-05-04,79,0,2759,109,4217737,2020-04-28,1.04560289836136,0.0518924005432591
Oregon,2020-05-05,80,4,2839,113,4217737,2020-04-29,1.17197393807839,0.0549429856642614
Oregon,2020-05-06,77,2,2916,115,4217737,2020-04-30,1.18095811482294,0.0544156775555969
Oregon,2020-05-07,73,6,2989,121,4217737,2020-05-01,1.15754009709745,0.0528342351997497
Oregon,2020-05-08,79,3,3068,124,4217737,2020-05-02,1.14047949372985,0.051521611784315
Oregon,2020-05-09,92,3,3160,127,4217737,2020-05-03,1.18665875178728,0.0517407803582301
Oregon,2020-05-10,68,0,3228,127,4217737,2020-05-04,1.1951298479212,0.0510068989475023
Pennsylvania,2020-03-08,4,0,6,0,12801989,2020-03-02,7.84150479393989,2.96381022704082
Pennsylvania,2020-03-09,1,0,7,0,12801989,2020-03-03,4.60228976791069,1.62715515193755
Pennsylvania,2020-03-10,5,0,12,0,12801989,2020-03-04,4.36640431610565,1.21102266547125
Pennsylvania,2020-03-11,4,0,16,0,12801989,2020-03-05,3.63436336418203,0.881462590141038
Pennsylvania,2020-03-12,6,0,22,0,12801989,2020-03-06,3.25421854757427,0.678551473661115
Pennsylvania,2020-03-13,19,0,41,0,12801989,2020-03-07,3.95321609116353,0.62505834654523
Pennsylvania,2020-03-14,6,0,47,0,12801989,2020-03-08,2.99990699029183,0.442312154931377
Pennsylvania,2020-03-15,0,0,47,0,12801989,2020-03-09,1.9050969302045,0.293962838333053
Pennsylvania,2020-03-16,32,0,79,0,12801989,2020-03-10,2.67598205672601,0.313200009795474
Pennsylvania,2020-03-17,33,0,112,0,12801989,2020-03-11,2.90442706229515,0.289001294323602
Pennsylvania,2020-03-18,43,1,155,1,12801989,2020-03-12,2.93375815617082,0.247947818803225
Pennsylvania,2020-03-19,51,0,206,1,12801989,2020-03-13,2.80986790869189,0.206585597262242
Pennsylvania,2020-03-20,105,0,311,1,12801989,2020-03-14,3.0134936476184,0.183056702487496
Pennsylvania,2020-03-21,88,1,399,2,12801989,2020-03-15,2.83415689146543,0.150846950609986
Pennsylvania,2020-03-22,110,2,509,4,12801989,2020-03-16,2.70092359607179,0.125522564481411
Pennsylvania,2020-03-23,189,2,698,6,12801989,2020-03-17,2.68783607740975,0.107946094514849
Pennsylvania,2020-03-24,248,2,946,8,12801989,2020-03-18,2.70536161253535,0.0936228991806697
Pennsylvania,2020-03-25,314,7,1260,15,12801989,2020-03-19,2.67270707904035,0.0803662678463538
Pennsylvania,2020-03-26,535,3,1795,18,12801989,2020-03-20,2.87229315875534,0.0720327842456759
Pennsylvania,2020-03-27,550,4,2345,22,12801989,2020-03-21,2.70015260641246,0.0598557812114291
Pennsylvania,2020-03-28,500,12,2845,34,12801989,2020-03-22,2.40081462227296,0.048533503485448
Pennsylvania,2020-03-29,587,7,3432,41,12801989,2020-03-23,2.20661110661513,0.040807229985582
Pennsylvania,2020-03-30,723,9,4155,50,12801989,2020-03-24,2.07585848420796,0.0353008570016174
Pennsylvania,2020-03-31,808,13,4963,63,12801989,2020-03-25,1.96209019082968,0.0309538020099727
Pennsylvania,2020-04-01,1046,11,6009,74,12801989,2020-03-26,1.92231769212413,0.0278919166160469
Pennsylvania,2020-04-02,1259,16,7268,90,12801989,2020-03-27,1.85525848503877,0.0250756402160515
Pennsylvania,2020-04-03,1302,12,8570,102,12801989,2020-03-28,1.78304194643026,0.0225973234499317
Pennsylvania,2020-04-04,1874,34,10444,136,12801989,2020-03-29,1.86178672307683,0.0213561583692569
Pennsylvania,2020-04-05,1145,15,11589,151,12801989,2020-03-30,1.70186543410949,0.0188422762644089
Pennsylvania,2020-04-06,1538,28,13127,179,12801989,2020-03-31,1.61284436853905,0.0170264312168779
Pennsylvania,2020-04-07,1726,68,14853,247,12801989,2020-04-01,1.56648050788657,0.0157508825929096
Pennsylvania,2020-04-08,1778,71,16631,318,12801989,2020-04-02,1.4974128861443,0.0145284062549042
Pennsylvania,2020-04-09,1669,27,18300,345,12801989,2020-04-03,1.39934888617544,0.0133222996383978
Pennsylvania,2020-04-10,1751,73,20051,418,12801989,2020-04-04,1.33230276117836,0.0124335217011095
Pennsylvania,2020-04-11,1668,85,21719,503,12801989,2020-04-05,1.21553794112408,0.0114469816233771
Pennsylvania,2020-04-12,1219,54,22938,557,12801989,2020-04-06,1.15844207247289,0.0108736760712184
Pennsylvania,2020-04-13,1354,32,24292,589,12801989,2020-04-07,1.09745156887477,0.0103857186162299
Pennsylvania,2020-04-14,1173,102,25465,691,12801989,2020-04-08,1.01633005033987,0.00986542239604918
Pennsylvania,2020-04-15,1288,88,26753,779,12801989,2020-04-09,0.959516659640076,0.00953669517122063
Pennsylvania,2020-04-16,1505,62,28258,841,12801989,2020-04-10,0.948317931705463,0.0095026798192286
Pennsylvania,2020-04-17,1630,80,29888,921,12801989,2020-04-11,0.947229646469886,0.00954996704806762
Pennsylvania,2020-04-18,1764,121,31652,1042,12801989,2020-04-12,0.967849812127304,0.00971059613793212
Pennsylvania,2020-04-19,1250,234,32902,1276,12801989,2020-04-13,0.979802331289399,0.00981521499504266
Pennsylvania,2020-04-20,1012,72,33914,1348,12801989,2020-04-14,0.951312362258979,0.00969768107573
Pennsylvania,2020-04-21,1335,266,35249,1614,12801989,2020-04-15,0.975244629884972,0.00985900649181079
Pennsylvania,2020-04-22,833,59,36082,1673,12801989,2020-04-16,0.937473616050247,0.0097055071094668
Pennsylvania,2020-04-23,2297,51,38379,1724,12801989,2020-04-17,1.02748061164747,0.0102126975185675
Pennsylvania,2020-04-24,1829,23,40208,1747,12801989,2020-04-18,1.05052335299548,0.0103405781724756
Pennsylvania,2020-04-25,945,46,41153,1793,12801989,2020-04-19,0.957454055933252,0.00982223747971284
Pennsylvania,2020-04-26,1463,23,42616,1816,12801989,2020-04-20,0.979726530848674,0.00993993321330683
Pennsylvania,2020-04-27,942,70,43558,1886,12801989,2020-04-21,0.980116845304567,0.00997991259021976
Pennsylvania,2020-04-28,1579,160,45137,2046,12801989,2020-04-22,1.00906902322727,0.0101471641457061
Pennsylvania,2020-04-29,1190,327,46327,2373,12801989,2020-04-23,1.04624323649291,0.0103360710909431
Pennsylvania,2020-04-30,1644,102,47971,2475,12801989,2020-04-24,0.972602203956096,0.0099302007225485
Pennsylvania,2020-05-01,1608,160,49579,2635,12801989,2020-04-25,0.949240406879305,0.00980528173698081
Pennsylvania,2020-05-02,915,60,50494,2695,12801989,2020-04-26,0.955745811572296,0.00988831908076328
Pennsylvania,2020-05-03,731,25,51225,2720,12801989,2020-04-27,0.890344428461075,0.00959525386750367
Pennsylvania,2020-05-04,1591,118,52816,2838,12801989,2020-04-28,0.975318133702725,0.0101359452709254
Pennsylvania,2020-05-05,1048,341,53864,3179,12801989,2020-04-29,0.932670819429044,0.00998322870321989
Pennsylvania,2020-05-06,936,166,54800,3345,12801989,2020-04-30,0.914710781804182,0.0099366402871863
Pennsylvania,2020-05-07,1156,244,55956,3589,12801989,2020-05-01,0.877811254089824,0.0098228269149413
Pennsylvania,2020-05-08,1415,126,57371,3715,12801989,2020-05-02,0.877696833269041,0.00994242201712433
Pennsylvania,2020-05-09,1189,64,58560,3779,12801989,2020-05-03,0.934579720407406,0.0104054370090853
Pennsylvania,2020-05-10,1379,27,59939,3806,12801989,2020-05-04,1.03029743039889,0.0110364378242841
Puerto Rico,2020-03-08,0,0,0,0,2933408,2020-03-02,5,5
Puerto Rico,2020-03-09,0,0,0,0,2933408,2020-03-03,5,5
Puerto Rico,2020-03-10,0,0,0,0,2933408,2020-03-04,5,5
Puerto Rico,2020-03-11,0,0,0,0,2933408,2020-03-05,5,5
Puerto Rico,2020-03-12,0,0,0,0,2933408,2020-03-06,5,5
Puerto Rico,2020-03-13,0,0,0,0,2933408,2020-03-07,5,5
Puerto Rico,2020-03-14,0,0,0,0,2933408,2020-03-08,5,5
Puerto Rico,2020-03-15,0,0,0,0,2933408,2020-03-09,5,5
Puerto Rico,2020-03-16,5,0,5,0,2933408,2020-03-10,30,12.2474487139159
Puerto Rico,2020-03-17,0,0,5,0,2933408,2020-03-11,7.05174997030763,2.87886487015669
Puerto Rico,2020-03-18,0,0,5,0,2933408,2020-03-12,3.10604904626181,1.2680392132333
Puerto Rico,2020-03-19,0,0,5,0,2933408,2020-03-13,2.18662265757865,0.892684961846031
Puerto Rico,2020-03-20,9,0,14,0,2933408,2020-03-14,4.47181866074871,1.15461861335595
Puerto Rico,2020-03-21,7,1,21,1,2933408,2020-03-15,4.41362652776337,0.940988337445277
Puerto Rico,2020-03-22,2,0,23,1,2933408,2020-03-16,2.93183408191447,0.598458125932635
Puerto Rico,2020-03-23,8,1,31,2,2933408,2020-03-17,2.31152169900471,0.44485255838601
Puerto Rico,2020-03-24,8,0,39,2,2933408,2020-03-18,2.34365213129295,0.396149514073159
Puerto Rico,2020-03-25,12,0,51,2,2933408,2020-03-19,2.5033037404162,0.365144378812457
Puerto Rico,2020-03-26,13,0,64,2,2933408,2020-03-20,2.48234937502808,0.320469926298405
Puerto Rico,2020-03-27,15,1,79,3,2933408,2020-03-21,2.10609208094319,0.259242014383062
Puerto Rico,2020-03-28,21,0,100,3,2933408,2020-03-22,2.04901719467226,0.229087086717655
Puerto Rico,2020-03-29,27,0,127,3,2933408,2020-03-23,2.21677636027327,0.216335221170126
Puerto Rico,2020-03-30,47,3,174,6,2933408,2020-03-24,2.4602014183041,0.205016784858675
Puerto Rico,2020-03-31,65,2,239,8,2933408,2020-03-25,2.68150057195227,0.189138467234886
Puerto Rico,2020-04-01,47,3,286,11,2933408,2020-03-26,2.37574097095,0.154647564890253
Puerto Rico,2020-04-02,30,1,316,12,2933408,2020-03-27,1.96184807895697,0.123340331967088
Puerto Rico,2020-04-03,0,3,316,15,2933408,2020-03-28,1.51038249491921,0.0979035557194643
Puerto Rico,2020-04-04,136,3,452,18,2933408,2020-03-29,1.9705298188578,0.104880719608663
Puerto Rico,2020-04-05,23,2,475,20,2933408,2020-03-30,1.67355134524619,0.0895831496572213
Puerto Rico,2020-04-06,38,1,513,21,2933408,2020-03-31,1.3950376918739,0.0756565412931219
Puerto Rico,2020-04-07,60,2,573,23,2933408,2020-04-01,1.24760311589145,0.0681638398203247
Puerto Rico,2020-04-08,47,1,620,24,2933408,2020-04-02,1.17366416386918,0.0641241233288124
Puerto Rico,2020-04-09,63,9,683,33,2933408,2020-04-03,1.23676228778663,0.0644706909414289
Puerto Rico,2020-04-10,42,6,725,39,2933408,2020-04-04,1.31851950368723,0.0651170368775804
Puerto Rico,2020-04-11,63,3,788,42,2933408,2020-04-05,1.01997520237306,0.0555615896788761
Puerto Rico,2020-04-12,109,2,897,44,2933408,2020-04-06,1.24235903953312,0.0604055635796102
Puerto Rico,2020-04-13,6,1,903,45,2933408,2020-04-07,1.11519301435615,0.0563977348783493
Puerto Rico,2020-04-14,20,0,923,45,2933408,2020-04-08,0.963656290785129,0.051436167582027
Puerto Rico,2020-04-15,51,6,974,51,2933408,2020-04-09,0.971317039835387,0.0515521557827011
Puerto Rico,2020-04-16,69,5,1043,56,2933408,2020-04-10,0.996671466551202,0.052456392976379
Puerto Rico,2020-04-17,25,2,1068,58,2933408,2020-04-11,0.952916348070012,0.0513778062216412
Puerto Rico,2020-04-18,50,2,1118,60,2933408,2020-04-12,0.923069869328091,0.0507365085920674
Puerto Rico,2020-04-19,95,2,1213,62,2933408,2020-04-13,0.89783878246901,0.0504276499972413
Puerto Rico,2020-04-20,39,1,1252,63,2933408,2020-04-14,1.01283713349555,0.0541384220306082
Puerto Rico,2020-04-21,46,1,1298,64,2933408,2020-04-15,1.09761162787672,0.0566049976566376
Puerto Rico,2020-04-22,-46,-1,1252,63,2933408,2020-04-16,0.934993218990366,0.0518640922043215
Puerto Rico,2020-04-23,164,6,1416,69,2933408,2020-04-17,1.20752945680679,0.0589214042492623
Puerto Rico,2020-04-24,-140,8,1276,77,2933408,2020-04-18,1.11482943084275,0.0560931562393677
Puerto Rico,2020-04-25,31,6,1307,83,2933408,2020-04-19,1.02400529779415,0.0528090410213224
Puerto Rico,2020-04-26,64,1,1371,84,2933408,2020-04-20,0.92885245416405,0.0500077351004236
Puerto Rico,2020-04-27,18,0,1389,84,2933408,2020-04-21,0.879649128000818,0.0488693960000455
Puerto Rico,2020-04-28,11,2,1400,86,2933408,2020-04-22,0.803673936213959,0.0472749374243505
Puerto Rico,2020-04-29,33,0,1433,86,2933408,2020-04-23,0.930644627823743,0.051862797473647
Puerto Rico,2020-04-30,106,6,1539,92,2933408,2020-04-24,0.785881381032688,0.0483676554621053
Puerto Rico,2020-05-01,36,2,1575,94,2933408,2020-04-25,0.923877748060329,0.0533401066540936
Puerto Rico,2020-05-02,182,1,1757,95,2933408,2020-04-26,1.43577653030244,0.0676080763252917
Puerto Rico,2020-05-03,51,2,1808,97,2933408,2020-04-27,1.32701301275522,0.0634071344102023
Puerto Rico,2020-05-04,35,0,1843,97,2933408,2020-04-28,1.27013815536057,0.0595449951523915
Puerto Rico,2020-05-05,81,2,1924,99,2933408,2020-04-29,1.3813325047268,0.0602862929791762
Puerto Rico,2020-05-06,44,0,1968,99,2933408,2020-04-30,1.31500417551164,0.0567995293366076
Puerto Rico,2020-05-07,63,3,2031,102,2933408,2020-05-01,1.12553973500722,0.05069176021717
Puerto Rico,2020-05-08,125,5,2156,107,2933408,2020-05-02,1.27472754590712,0.0528391567729685
Puerto Rico,2020-05-09,17,1,2173,108,2933408,2020-05-03,0.874197979686725,0.0428096592477926
Puerto Rico,2020-05-10,25,3,2198,111,2933408,2020-05-04,0.812173156695205,0.0410733619893175
Rhode Island,2020-03-08,0,0,3,0,1059361,2020-03-02,1.52666675417553,0.881421461486097
Rhode Island,2020-03-09,0,0,3,0,1059361,2020-03-03,0.933792193069217,0.660290791938301
Rhode Island,2020-03-10,0,0,3,0,1059361,2020-03-04,0.987119755933445,0.697999073263749
Rhode Island,2020-03-11,2,0,5,0,1059361,2020-03-05,2.19684518078808,1.09842259039404
Rhode Island,2020-03-12,-2,0,3,0,1059361,2020-03-06,2.07592403309037,1.03796201654518
Rhode Island,2020-03-13,9,0,12,0,1059361,2020-03-07,5.79514059718901,1.60728281320677
Rhode Island,2020-03-14,8,0,20,0,1059361,2020-03-08,5.47560349114142,1.22438216240274
Rhode Island,2020-03-15,0,0,20,0,1059361,2020-03-09,2.99043478743302,0.668681546698037
Rhode Island,2020-03-16,1,0,21,0,1059361,2020-03-10,2.14340193692329,0.46772864860314
Rhode Island,2020-03-17,2,0,23,0,1059361,2020-03-11,1.87534467779429,0.391036396645331
Rhode Island,2020-03-18,10,0,33,0,1059361,2020-03-12,2.13838423120465,0.384065145694804
Rhode Island,2020-03-19,11,0,44,0,1059361,2020-03-13,2.40650723332542,0.371332127810117
Rhode Island,2020-03-20,10,0,54,0,1059361,2020-03-14,1.94988752339414,0.29735505962699
Rhode Island,2020-03-21,12,0,66,0,1059361,2020-03-15,1.74453350690281,0.254466365152171
Rhode Island,2020-03-22,17,0,83,0,1059361,2020-03-16,2.04773033613646,0.255966292017057
Rhode Island,2020-03-23,23,0,106,0,1059361,2020-03-17,2.31298407905103,0.249415487619474
Rhode Island,2020-03-24,18,0,124,0,1059361,2020-03-18,2.19301221019486,0.217140565164229
Rhode Island,2020-03-25,8,0,132,0,1059361,2020-03-19,1.71794442530785,0.171794442530785
Rhode Island,2020-03-26,33,0,165,0,1059361,2020-03-20,1.7775712222177,0.160933736747191
Rhode Island,2020-03-27,38,0,203,0,1059361,2020-03-21,1.89649377393736,0.154848068217058
Rhode Island,2020-03-28,36,2,239,2,1059361,2020-03-22,1.86690140590146,0.14152943033686
Rhode Island,2020-03-29,55,1,294,3,1059361,2020-03-23,1.9230194994985,0.13207352146772
Rhode Island,2020-03-30,114,1,408,4,1059361,2020-03-24,2.31587736633211,0.13304367847618
Rhode Island,2020-03-31,80,4,488,8,1059361,2020-03-25,2.24403059104614,0.117457929437781
Rhode Island,2020-04-01,78,2,566,10,1059361,2020-03-26,2.11777004426768,0.101539301721143
Rhode Island,2020-04-02,79,2,645,12,1059361,2020-03-27,1.89384317773987,0.0863518160605072
Rhode Island,2020-04-03,66,2,711,14,1059361,2020-03-28,1.67018156846244,0.0740294964793201
Rhode Island,2020-04-04,95,3,806,17,1059361,2020-03-29,1.61362005302885,0.0677059933937765
Rhode Island,2020-04-05,116,8,922,25,1059361,2020-03-30,1.57841122250809,0.0629353768963577
Rhode Island,2020-04-06,160,2,1082,27,1059361,2020-03-31,1.50546090258392,0.0579452171574187
Rhode Island,2020-04-07,147,3,1229,30,1059361,2020-04-01,1.48683112557024,0.0545832877768857
Rhode Island,2020-04-08,221,5,1450,35,1059361,2020-04-02,1.60530057822717,0.053961588624164
Rhode Island,2020-04-09,277,8,1727,43,1059361,2020-04-03,1.75496076495015,0.0533277405295369
Rhode Island,2020-04-10,0,0,1727,43,1059361,2020-04-04,1.43388873959186,0.0449629686758106
Rhode Island,2020-04-11,622,13,2349,56,1059361,2020-04-05,1.9461706304555,0.0495287384705766
Rhode Island,2020-04-12,316,7,2665,63,1059361,2020-04-06,1.9011587402043,0.0455244953436402
Rhode Island,2020-04-13,0,0,2665,63,1059361,2020-04-07,1.44142703194801,0.0362172168761149
Rhode Island,2020-04-14,586,17,3251,80,1059361,2020-04-08,1.63381781432794,0.0363250052462088
Rhode Island,2020-04-15,0,0,3251,80,1059361,2020-04-09,1.30476811760269,0.0307366083082615
Rhode Island,2020-04-16,278,7,3529,87,1059361,2020-04-10,1.19273527794745,0.0280896418169498
Rhode Island,2020-04-17,648,31,4177,118,1059361,2020-04-11,1.54760153122001,0.0312598935750222
Rhode Island,2020-04-18,314,19,4491,137,1059361,2020-04-12,1.24420604917709,0.0268770267143982
Rhode Island,2020-04-19,215,13,4706,150,1059361,2020-04-13,1.09598162502287,0.0242535549499849
Rhode Island,2020-04-20,384,5,5090,155,1059361,2020-04-14,1.2639577128217,0.0256618017843012
Rhode Island,2020-04-21,410,16,5500,171,1059361,2020-04-15,1.12520731503233,0.0237214530358986
Rhode Island,2020-04-22,341,10,5841,181,1059361,2020-04-16,1.24418667523676,0.0244428498197048
Rhode Island,2020-04-23,415,8,6256,189,1059361,2020-04-17,1.25812526223081,0.0240880530939316
Rhode Island,2020-04-24,443,13,6699,202,1059361,2020-04-18,1.10127098085957,0.0219247964568964
Rhode Island,2020-04-25,430,13,7129,215,1059361,2020-04-19,1.11222910798303,0.0216508305802391
Rhode Island,2020-04-26,310,11,7439,226,1059361,2020-04-20,1.12743970511367,0.0215622496585814
Rhode Island,2020-04-27,269,7,7708,233,1059361,2020-04-21,1.05167050192664,0.0205500055473574
Rhode Island,2020-04-28,219,6,7927,239,1059361,2020-04-22,0.957521090197843,0.0194322910806945
Rhode Island,2020-04-29,320,12,8247,251,1059361,2020-04-23,0.950875503509345,0.0193814209449543
Rhode Island,2020-04-30,374,15,8621,266,1059361,2020-04-24,0.945366222435335,0.0194353654361635
Rhode Island,2020-05-01,341,13,8962,279,1059361,2020-04-25,0.915337000395712,0.0192372419322886
Rhode Island,2020-05-02,327,17,9289,296,1059361,2020-04-26,0.888117375328665,0.0191048214556129
Rhode Island,2020-05-03,188,24,9477,320,1059361,2020-04-27,0.857597823961178,0.0189921904869183
Rhode Island,2020-05-04,175,21,9652,341,1059361,2020-04-28,0.842841913435252,0.0191111280123376
Rhode Island,2020-05-05,281,14,9933,355,1059361,2020-04-29,0.900620472341094,0.0201033358725296
Rhode Island,2020-05-06,272,15,10205,370,1059361,2020-04-30,0.904478792007158,0.0204353071683844
Rhode Island,2020-05-07,325,18,10530,388,1059361,2020-05-01,0.90096298001932,0.0206153286557339
Rhode Island,2020-05-08,249,11,10779,399,1059361,2020-05-02,0.876830813098405,0.0205645335746634
Rhode Island,2020-05-09,210,19,10989,418,1059361,2020-05-03,0.841829626855756,0.0204113650122907
Rhode Island,2020-05-10,285,4,11274,422,1059361,2020-05-04,0.919777927232567,0.021691427793584
South Carolina,2020-03-08,0,0,2,0,5148714,2020-03-02,6.51690738866037,3.76253823512692
South Carolina,2020-03-09,1,0,3,0,5148714,2020-03-03,4.48085988225137,2.24042994112568
South Carolina,2020-03-10,4,0,7,0,5148714,2020-03-04,5.93580313995374,2.09862332602485
South Carolina,2020-03-11,3,0,10,0,5148714,2020-03-05,4.72354186060881,1.42420145756151
South Carolina,2020-03-12,-3,0,7,0,5148714,2020-03-06,2.79906333334637,0.843949349195581
South Carolina,2020-03-13,1,0,8,0,5148714,2020-03-07,2.18652845872395,0.631196397117526
South Carolina,2020-03-14,11,0,19,0,5148714,2020-03-08,3.09309164728941,0.674967933578065
South Carolina,2020-03-15,0,0,19,0,5148714,2020-03-09,2.31864560442732,0.505969952003088
South Carolina,2020-03-16,11,1,30,1,5148714,2020-03-10,2.62127692929055,0.470795234581047
South Carolina,2020-03-17,17,0,47,1,5148714,2020-03-11,2.89301288396347,0.436138102262309
South Carolina,2020-03-18,13,0,60,1,5148714,2020-03-12,2.61794520339572,0.356257217938125
South Carolina,2020-03-19,20,0,80,1,5148714,2020-03-13,2.6871464785547,0.312374433090753
South Carolina,2020-03-20,46,2,126,3,5148714,2020-03-14,3.25854376359012,0.298710217058371
South Carolina,2020-03-21,48,0,174,3,5148714,2020-03-15,3.02953675368334,0.242557063625985
South Carolina,2020-03-22,22,0,196,3,5148714,2020-03-16,2.44211871577877,0.183044536576606
South Carolina,2020-03-23,102,2,298,5,5148714,2020-03-17,2.79603111812207,0.170477026038962
South Carolina,2020-03-24,44,0,342,5,5148714,2020-03-18,2.30922166425184,0.134220782902675
South Carolina,2020-03-25,82,2,424,7,5148714,2020-03-19,2.19227060565665,0.114748687979203
South Carolina,2020-03-26,0,2,424,9,5148714,2020-03-20,1.66295383452192,0.0895304248464833
South Carolina,2020-03-27,118,4,542,13,5148714,2020-03-21,1.71033654720593,0.0837555410631018
South Carolina,2020-03-28,118,2,660,15,5148714,2020-03-22,1.75096261476305,0.0793436897638015
South Carolina,2020-03-29,114,1,774,16,5148714,2020-03-23,1.80061101398116,0.0748308400175887
South Carolina,2020-03-30,151,2,925,18,5148714,2020-03-24,1.67712377326499,0.066924524353582
South Carolina,2020-03-31,158,4,1083,22,5148714,2020-03-25,1.71972111863889,0.0631329483895849
South Carolina,2020-04-01,210,4,1293,26,5148714,2020-03-26,1.75775592755042,0.0595935071372542
South Carolina,2020-04-02,261,5,1554,31,5148714,2020-03-27,1.97447673819591,0.0587111678364099
South Carolina,2020-04-03,146,3,1700,34,5148714,2020-03-28,1.70329924838123,0.0500321581618573
South Carolina,2020-04-04,217,6,1917,40,5148714,2020-03-29,1.58067314328583,0.0445658048125368
South Carolina,2020-04-05,132,4,2049,44,5148714,2020-03-30,1.4196719336612,0.0397431841835562
South Carolina,2020-04-06,183,4,2232,48,5148714,2020-03-31,1.32092791172778,0.0365237402161148
South Carolina,2020-04-07,185,3,2417,51,5148714,2020-04-01,1.25328082275877,0.0343010773975524
South Carolina,2020-04-08,0,0,2417,51,5148714,2020-04-02,0.996580393597243,0.0297122867350258
South Carolina,2020-04-09,376,16,2793,67,5148714,2020-04-03,1.07586959882153,0.0305526435378664
South Carolina,2020-04-10,274,5,3067,72,5148714,2020-04-04,1.1788240518694,0.0318717521595631
South Carolina,2020-04-11,144,8,3211,80,5148714,2020-04-05,1.08213855432614,0.0300710079947724
South Carolina,2020-04-12,109,2,3320,82,5148714,2020-04-06,1.03450463253846,0.0290060695603396
South Carolina,2020-04-13,71,0,3391,82,5148714,2020-04-07,0.933495595319659,0.027408374419981
South Carolina,2020-04-14,162,15,3553,97,5148714,2020-04-08,0.920528856192582,0.0272996560086579
South Carolina,2020-04-15,103,9,3656,106,5148714,2020-04-09,1.02201625051609,0.0290233112136713
South Carolina,2020-04-16,275,5,3931,111,5148714,2020-04-10,0.943242000888331,0.0279486779155201
South Carolina,2020-04-17,168,5,4099,116,5148714,2020-04-11,0.859215818543619,0.0267332711410492
South Carolina,2020-04-18,149,3,4248,119,5148714,2020-04-12,0.885257003124643,0.0274770873470301
South Carolina,2020-04-19,129,1,4377,120,5148714,2020-04-13,0.92944492589288,0.0285746439060123
South Carolina,2020-04-20,69,3,4446,123,5148714,2020-04-14,0.946416219664183,0.029123945891372
South Carolina,2020-04-21,-7,1,4439,124,5148714,2020-04-15,0.812013202314324,0.027157784072324
South Carolina,2020-04-22,322,16,4761,140,5148714,2020-04-16,1.04164182925721,0.031222726829544
South Carolina,2020-04-23,156,10,4917,150,5148714,2020-04-17,0.943570469822144,0.0299282379716701
South Carolina,2020-04-24,153,7,5070,157,5148714,2020-04-18,0.930115913947161,0.0297266335284951
South Carolina,2020-04-25,183,9,5253,166,5148714,2020-04-19,0.977938114983669,0.0307260441559704
South Carolina,2020-04-26,245,8,5498,174,5148714,2020-04-20,1.1004428283239,0.0327506944653448
South Carolina,2020-04-27,115,3,5613,177,5148714,2020-04-21,1.13238489326762,0.033035062565765
South Carolina,2020-04-28,122,15,5735,192,5148714,2020-04-22,1.21655089559321,0.0337800505192486
South Carolina,2020-04-29,147,39,5882,231,5148714,2020-04-23,1.01184290481115,0.0302076306307105
South Carolina,2020-04-30,213,13,6095,244,5148714,2020-04-24,1.0409270150254,0.0303154051905253
South Carolina,2020-05-01,163,12,6258,256,5148714,2020-04-25,1.04553225687229,0.0303212086499755
South Carolina,2020-05-02,231,11,6489,267,5148714,2020-04-26,1.0768638546112,0.0306179387631691
South Carolina,2020-05-03,137,8,6626,275,5148714,2020-04-27,0.969290605962183,0.0288474236615703
South Carolina,2020-05-04,131,8,6757,283,5148714,2020-04-28,0.979919707702861,0.0289592792490418
South Carolina,2020-05-05,84,13,6841,296,5148714,2020-04-29,0.953866699022111,0.0286690879342899
South Carolina,2020-05-06,95,9,6936,305,5148714,2020-04-30,0.916170568829454,0.028206558868685
South Carolina,2020-05-07,206,11,7142,316,5148714,2020-05-01,0.924572098249832,0.0285601274944984
South Carolina,2020-05-08,225,4,7367,320,5148714,2020-05-02,0.997413065131294,0.0299373643801717
South Carolina,2020-05-09,164,10,7531,330,5148714,2020-05-03,0.944210290591683,0.0292365804185888
South Carolina,2020-05-10,122,1,7653,331,5148714,2020-05-04,0.937065372133042,0.0292262659645128
South Dakota,2020-03-08,0,0,0,0,884659,2020-03-02,5,5
South Dakota,2020-03-09,0,0,0,0,884659,2020-03-03,5,5
South Dakota,2020-03-10,0,0,0,0,884659,2020-03-04,5,5
South Dakota,2020-03-11,8,1,8,1,884659,2020-03-05,45,15
South Dakota,2020-03-12,-1,0,7,1,884659,2020-03-06,7.25008821401198,2.41669607133733
South Dakota,2020-03-13,1,0,8,1,884659,2020-03-07,3.3661610219189,1.06447358001437
South Dakota,2020-03-14,0,0,8,1,884659,2020-03-08,2.27246759759622,0.718617351733505
South Dakota,2020-03-15,0,0,8,1,884659,2020-03-09,1.78785753504506,0.565370194263669
South Dakota,2020-03-16,2,0,10,1,884659,2020-03-10,1.84910189828693,0.533789739367504
South Dakota,2020-03-17,1,0,11,1,884659,2020-03-11,1.75118025054915,0.485690014302681
South Dakota,2020-03-18,0,0,11,1,884659,2020-03-12,0.588771062229684,0.263306423666067
South Dakota,2020-03-19,3,0,14,1,884659,2020-03-13,0.955525395385667,0.337829243336581
South Dakota,2020-03-20,0,0,14,1,884659,2020-03-14,0.906038227252049,0.342450261089535
South Dakota,2020-03-21,0,0,14,1,884659,2020-03-15,0.937701277742391,0.354417769281982
South Dakota,2020-03-22,7,0,21,1,884659,2020-03-16,1.95785936253772,0.523259924721699
South Dakota,2020-03-23,7,0,28,1,884659,2020-03-17,2.42792940246503,0.55700520565243
South Dakota,2020-03-24,2,0,30,1,884659,2020-03-18,2.03829721494426,0.455777113096387
South Dakota,2020-03-25,11,0,41,1,884659,2020-03-19,2.57756325402044,0.462944026731458
South Dakota,2020-03-26,5,0,46,1,884659,2020-03-20,2.16515171429145,0.376904535212316
South Dakota,2020-03-27,12,0,58,1,884659,2020-03-21,2.34139488826749,0.349034542155776
South Dakota,2020-03-28,10,0,68,1,884659,2020-03-22,2.29096463964822,0.308913608991796
South Dakota,2020-03-29,22,0,90,1,884659,2020-03-23,2.30814450656014,0.275876034871869
South Dakota,2020-03-30,11,0,101,1,884659,2020-03-24,1.93652216465595,0.225116129016323
South Dakota,2020-03-31,7,0,108,1,884659,2020-03-25,1.70132009946206,0.191413465950702
South Dakota,2020-04-01,21,1,129,2,884659,2020-03-26,1.65620805275357,0.175557702476824
South Dakota,2020-04-02,36,0,165,2,884659,2020-03-27,1.9633998036119,0.179233060306575
South Dakota,2020-04-03,22,0,187,2,884659,2020-03-28,1.80846581646711,0.158612944697511
South Dakota,2020-04-04,25,0,212,2,884659,2020-03-29,1.70698874801016,0.141757699683438
South Dakota,2020-04-05,28,0,240,2,884659,2020-03-30,1.54245541841768,0.125523241767735
South Dakota,2020-04-06,48,2,288,4,884659,2020-03-31,1.70622888825339,0.124439531139271
South Dakota,2020-04-07,32,2,320,6,884659,2020-04-01,1.70474217669671,0.11680700926394
South Dakota,2020-04-08,73,0,393,6,884659,2020-04-02,1.8444857656663,0.113305859891854
South Dakota,2020-04-09,54,0,447,6,884659,2020-04-03,1.68984238003827,0.10045070287476
South Dakota,2020-04-10,89,0,536,6,884659,2020-04-04,1.80548617145916,0.0965072952879766
South Dakota,2020-04-11,90,0,626,6,884659,2020-04-05,1.84829617734158,0.0907292909648096
South Dakota,2020-04-12,104,0,730,6,884659,2020-04-06,1.86002288091488,0.0839416575288467
South Dakota,2020-04-13,138,0,868,6,884659,2020-04-07,1.86695176620486,0.0774542105287533
South Dakota,2020-04-14,120,0,988,6,884659,2020-04-08,1.82088993061162,0.0703996719507024
South Dakota,2020-04-15,180,0,1168,6,884659,2020-04-09,1.79736673599368,0.0645217056067399
South Dakota,2020-04-16,143,1,1311,7,884659,2020-04-10,1.71478652330688,0.0583044909534003
South Dakota,2020-04-17,100,0,1411,7,884659,2020-04-11,1.5017688083694,0.0507400658764829
South Dakota,2020-04-18,131,0,1542,7,884659,2020-04-12,1.4009602707768,0.0462637840026665
South Dakota,2020-04-19,93,0,1635,7,884659,2020-04-13,1.26762164222345,0.0421139082361653
South Dakota,2020-04-20,50,0,1685,7,884659,2020-04-14,1.07157306917413,0.0374666737420729
South Dakota,2020-04-21,70,1,1755,8,884659,2020-04-15,0.975661505152351,0.0352061520398541
South Dakota,2020-04-22,103,1,1858,9,884659,2020-04-16,0.876774731457375,0.0333540827062061
South Dakota,2020-04-23,98,0,1956,9,884659,2020-04-17,0.835819008516938,0.0328848590555841
South Dakota,2020-04-24,84,1,2040,10,884659,2020-04-18,0.843954837561605,0.0336239655613264
South Dakota,2020-04-25,107,0,2147,10,884659,2020-04-19,0.842566596345286,0.0342269283250646
South Dakota,2020-04-26,65,1,2212,11,884659,2020-04-20,0.833174595805311,0.0346554945062527
South Dakota,2020-04-27,32,0,2244,11,884659,2020-04-21,0.838216540416783,0.0354211137758531
South Dakota,2020-04-28,69,0,2313,11,884659,2020-04-22,0.869152799018737,0.0367612465125412
South Dakota,2020-04-29,60,2,2373,13,884659,2020-04-23,0.829368474001852,0.0365109112306415
South Dakota,2020-04-30,76,4,2449,17,884659,2020-04-24,0.822418728426827,0.0370023679313189
South Dakota,2020-05-01,76,4,2525,21,884659,2020-04-25,0.842926171655356,0.0382359076183942
South Dakota,2020-05-02,63,0,2588,21,884659,2020-04-26,0.796677746144848,0.0378940960313432
South Dakota,2020-05-03,43,0,2631,21,884659,2020-04-27,0.789802785356232,0.0385384297922051
South Dakota,2020-05-04,37,0,2668,21,884659,2020-04-28,0.839251205009656,0.0407096631139025
South Dakota,2020-05-05,53,3,2721,24,884659,2020-04-29,0.842634367255885,0.041665587897776
South Dakota,2020-05-06,59,5,2780,29,884659,2020-04-30,0.871618773727938,0.043151559360953
South Dakota,2020-05-07,126,2,2906,31,884659,2020-05-01,1.01086073676291,0.0472344202527479
South Dakota,2020-05-08,239,0,3145,31,884659,2020-05-02,1.38558630619057,0.055601663164904
South Dakota,2020-05-09,248,3,3393,34,884659,2020-05-03,1.70891687661349,0.0601940296452317
South Dakota,2020-05-10,124,0,3517,34,884659,2020-05-04,1.66527451212263,0.0559144458479354
Tennessee,2020-03-08,2,0,3,0,6829174,2020-03-02,5.64340827261365,2.82170413630682
Tennessee,2020-03-09,0,0,3,0,6829174,2020-03-03,3.66565877386782,1.83282938693391
Tennessee,2020-03-10,0,0,3,0,6829174,2020-03-04,2.47633325063267,1.23816662531634
Tennessee,2020-03-11,6,0,9,0,6829174,2020-03-05,4.97728484001965,1.57395566578889
Tennessee,2020-03-12,9,0,18,0,6829174,2020-03-06,5.83258623724253,1.37475376006984
Tennessee,2020-03-13,8,0,26,0,6829174,2020-03-07,4.6042844626194,0.902974473885708
Tennessee,2020-03-14,6,0,32,0,6829174,2020-03-08,3.34746147769802,0.591753177660252
Tennessee,2020-03-15,0,0,32,0,6829174,2020-03-09,2.10858813761379,0.384973762486294
Tennessee,2020-03-16,20,0,52,0,6829174,2020-03-10,2.74948363826815,0.388835705076174
Tennessee,2020-03-17,22,0,74,0,6829174,2020-03-11,3.06043556044244,0.36067578969555
Tennessee,2020-03-18,26,0,100,0,6829174,2020-03-12,2.80741405642801,0.292693148495841
Tennessee,2020-03-19,54,0,154,0,6829174,2020-03-13,3.04956657152171,0.260542055309662
Tennessee,2020-03-20,69,1,223,1,6829174,2020-03-14,3.17905682422616,0.225925730753403
Tennessee,2020-03-21,81,0,304,1,6829174,2020-03-15,3.08150157731281,0.186500959655206
Tennessee,2020-03-22,89,1,393,2,6829174,2020-03-16,2.88797778689044,0.151788742563423
Tennessee,2020-03-23,221,0,614,2,6829174,2020-03-17,3.24629176391605,0.136814885869575
Tennessee,2020-03-24,158,0,772,2,6829174,2020-03-18,2.83848219718941,0.107361256800333
Tennessee,2020-03-25,144,1,916,3,6829174,2020-03-19,2.38553915355252,0.0834594504486742
Tennessee,2020-03-26,181,0,1097,3,6829174,2020-03-20,2.11543084688776,0.06885140955289
Tennessee,2020-03-27,221,3,1318,6,6829174,2020-03-21,1.97577612259483,0.0596805003566884
Tennessee,2020-03-28,193,1,1511,7,6829174,2020-03-22,1.80016108253526,0.0517938150175127
Tennessee,2020-03-29,209,1,1720,8,6829174,2020-03-23,1.67880089010716,0.0460680843431615
Tennessee,2020-03-30,197,6,1917,14,6829174,2020-03-24,1.43283119054469,0.0396785900277888
Tennessee,2020-03-31,474,9,2391,23,6829174,2020-03-25,1.60296938967317,0.0398260946795617
Tennessee,2020-04-01,542,1,2933,24,6829174,2020-03-26,1.7946232819021,0.0399496258868099
Tennessee,2020-04-02,80,12,3013,36,6829174,2020-03-27,1.47548990686201,0.0336996341882109
Tennessee,2020-04-03,54,5,3067,41,6829174,2020-03-28,1.19493546042549,0.0285644209721742
Tennessee,2020-04-04,255,9,3322,50,6829174,2020-03-29,1.16525088256754,0.027374131164702
Tennessee,2020-04-05,311,3,3633,53,6829174,2020-03-30,1.18781932239651,0.0271505992191997
Tennessee,2020-04-06,169,12,3802,65,6829174,2020-03-31,1.12644137362511,0.0259380754554408
Tennessee,2020-04-07,337,7,4139,72,6829174,2020-04-01,1.01096701427835,0.0241736417129134
Tennessee,2020-04-08,224,8,4363,80,6829174,2020-04-02,0.817360494538298,0.0216069678765655
Tennessee,2020-04-09,271,14,4634,94,6829174,2020-04-03,0.949244304270965,0.0235696196909103
Tennessee,2020-04-10,257,4,4891,98,6829174,2020-04-04,1.09651113487931,0.0256673842279212
Tennessee,2020-04-11,241,8,5132,106,6829174,2020-04-05,1.07793401716464,0.0253298695020306
Tennessee,2020-04-12,376,0,5508,106,6829174,2020-04-06,1.09447489782077,0.0252690775526602
Tennessee,2020-04-13,102,3,5610,109,6829174,2020-04-07,1.03583505527572,0.0243540571663794
Tennessee,2020-04-14,217,15,5827,124,6829174,2020-04-08,0.954398451519352,0.0232228170736778
Tennessee,2020-04-15,0,0,5827,124,6829174,2020-04-09,0.830664388795687,0.0217023508393556
Tennessee,2020-04-16,339,12,6166,136,6829174,2020-04-10,0.893492211645131,0.0228202130031071
Tennessee,2020-04-17,97,5,6263,141,6829174,2020-04-11,0.826074388226388,0.0222937891220515
Tennessee,2020-04-18,326,1,6589,142,6829174,2020-04-12,0.906168083224199,0.0237317628349129
Tennessee,2020-04-19,481,6,7070,148,6829174,2020-04-13,1.00115677810454,0.0253234342844117
Tennessee,2020-04-20,168,4,7238,152,6829174,2020-04-14,1.05163463531247,0.0260557956139511
Tennessee,2020-04-21,156,5,7394,157,6829174,2020-04-15,1.00455858108316,0.0253689351708228
Tennessee,2020-04-22,0,0,7394,157,6829174,2020-04-16,0.998933797991789,0.0252268879470153
Tennessee,2020-04-23,872,14,8266,171,6829174,2020-04-17,1.33901925046849,0.029212840971766
Tennessee,2020-04-24,462,-2,8728,169,6829174,2020-04-18,1.50551493670929,0.0303171611701555
Tennessee,2020-04-25,461,8,9189,177,6829174,2020-04-19,1.4447088652098,0.0283276248080353
Tennessee,2020-04-26,478,4,9667,181,6829174,2020-04-20,1.31002853367813,0.025701660450331
Tennessee,2020-04-27,251,3,9918,184,6829174,2020-04-21,1.25507922812558,0.0242394485277228
Tennessee,2020-04-28,134,4,10052,188,6829174,2020-04-22,1.17576148533234,0.0228013237542431
Tennessee,2020-04-29,314,7,10366,195,6829174,2020-04-23,1.25830481751918,0.0230774811411407
Tennessee,2020-04-30,369,4,10735,199,6829174,2020-04-24,0.997168396762086,0.0200641159684541
Tennessee,2020-05-01,1156,5,11891,204,6829174,2020-04-25,1.24832166473532,0.0221926043381482
Tennessee,2020-05-02,770,5,12661,209,6829174,2020-04-26,1.33132092259924,0.0225907352346579
Tennessee,2020-05-03,516,1,13177,210,6829174,2020-04-27,1.25990456910344,0.0212628872460464
Tennessee,2020-05-04,394,9,13571,219,6829174,2020-04-28,1.23361631892076,0.0204077833112552
Tennessee,2020-05-05,119,7,13690,226,6829174,2020-04-29,1.16751671207642,0.0193540597766268
Tennessee,2020-05-06,248,13,13938,239,6829174,2020-04-30,1.09999078398596,0.0184023183055496
Tennessee,2020-05-07,158,-1,14096,238,6829174,2020-05-01,1.00763084395519,0.0173781122608155
Tennessee,2020-05-08,345,4,14441,242,6829174,2020-05-02,0.757503676554971,0.0149978676126317
Tennessee,2020-05-09,327,0,14768,242,6829174,2020-05-03,0.64653225103347,0.0140816936019583
Tennessee,2020-05-10,217,1,14985,243,6829174,2020-05-04,0.597762131944529,0.0140542966364454
Texas,2020-03-08,3,0,11,0,28995881,2020-03-02,4.62713111656209,1.33573769786141
Texas,2020-03-09,2,0,13,0,28995881,2020-03-03,3.19833417050642,0.854790762460489
Texas,2020-03-10,3,0,16,0,28995881,2020-03-04,2.68425817549185,0.651028234351802
Texas,2020-03-11,5,0,21,0,28995881,2020-03-05,2.60963955367513,0.556377022273474
Texas,2020-03-12,6,0,27,0,28995881,2020-03-06,2.27023275343553,0.454046550687105
Texas,2020-03-13,17,0,44,0,28995881,2020-03-07,2.94233185332209,0.459515034257986
Texas,2020-03-14,16,0,60,0,28995881,2020-03-08,2.85430273015141,0.39206863269388
Texas,2020-03-15,3,0,63,0,28995881,2020-03-09,2.0779071217894,0.285422494081989
Texas,2020-03-16,22,0,85,0,28995881,2020-03-10,2.27128537642763,0.265833846066884
Texas,2020-03-17,25,1,110,1,28995881,2020-03-11,2.39119618026917,0.245331551654488
Texas,2020-03-18,86,2,196,3,28995881,2020-03-12,3.4739640804958,0.261859895231285
Texas,2020-03-19,110,2,306,5,28995881,2020-03-13,3.88746166652836,0.232320270076273
Texas,2020-03-20,123,-1,429,4,28995881,2020-03-14,3.47106250485179,0.17667242977312
Texas,2020-03-21,153,1,582,5,28995881,2020-03-15,3.1363611597873,0.13714349803332
Texas,2020-03-22,61,2,643,7,28995881,2020-03-16,2.43222456535641,0.100905677880084
Texas,2020-03-23,115,2,758,9,28995881,2020-03-17,2.12726797494943,0.0819393008066621
Texas,2020-03-24,197,3,955,12,28995881,2020-03-18,2.14505472375376,0.073748500548914
Texas,2020-03-25,274,3,1229,15,28995881,2020-03-19,2.12724765981596,0.0661542553371969
Texas,2020-03-26,334,6,1563,21,28995881,2020-03-20,2.09737592033261,0.0591338230051495
Texas,2020-03-27,374,5,1937,26,28995881,2020-03-21,2.0484188062919,0.0527319867765649
Texas,2020-03-28,518,4,2455,30,28995881,2020-03-22,2.08522693800409,0.0481691001656384
Texas,2020-03-29,337,7,2792,37,28995881,2020-03-23,1.95866007842479,0.042241549603882
Texas,2020-03-30,355,8,3147,45,28995881,2020-03-24,1.80193995421225,0.0368588146442853
Texas,2020-03-31,662,9,3809,54,28995881,2020-03-25,1.82768360781753,0.034205658887451
Texas,2020-04-01,546,12,4355,66,28995881,2020-03-26,1.71045144712927,0.0305876991658077
Texas,2020-04-02,714,11,5069,77,28995881,2020-03-27,1.65536196235226,0.0279527852890997
Texas,2020-04-03,665,23,5734,100,28995881,2020-03-28,1.57042497128585,0.0254823638299268
Texas,2020-04-04,833,16,6567,116,28995881,2020-03-29,1.50843727030721,0.0235205731055844
Texas,2020-04-05,642,20,7209,136,28995881,2020-03-30,1.45629815573202,0.0219097510925016
Texas,2020-04-06,834,14,8043,150,28995881,2020-03-31,1.4655321566829,0.0209425856440793
Texas,2020-04-07,882,10,8925,160,28995881,2020-04-01,1.39384164518211,0.0194852385805596
Texas,2020-04-08,852,29,9777,189,28995881,2020-04-02,1.35431465967017,0.0183907642509998
Texas,2020-04-09,1431,21,11208,210,28995881,2020-04-03,1.42115846614187,0.0181367021569008
Texas,2020-04-10,897,28,12105,238,28995881,2020-04-04,1.35934003609005,0.0170290423138719
Texas,2020-04-11,918,28,13023,266,28995881,2020-04-05,1.27143047821962,0.015822577252066
Texas,2020-04-12,654,17,13677,283,28995881,2020-04-06,1.19555997003563,0.0148645850390552
Texas,2020-04-13,598,22,14275,305,28995881,2020-04-07,1.09886661739715,0.0139186276458801
Texas,2020-04-14,731,37,15006,342,28995881,2020-04-08,1.0415614476734,0.0133555472655435
Texas,2020-04-15,901,33,15907,375,28995881,2020-04-09,1.0361151078507,0.0132325135762878
Texas,2020-04-16,969,39,16876,414,28995881,2020-04-10,0.950471470096717,0.0126236765082484
Texas,2020-04-17,973,37,17849,451,28995881,2020-04-11,0.966281472885769,0.0127484867263008
Texas,2020-04-18,855,25,18704,476,28995881,2020-04-12,0.965266542107686,0.0128055028850129
Texas,2020-04-19,556,14,19260,490,28995881,2020-04-13,0.955689457106593,0.0127892209439822
Texas,2020-04-20,491,17,19751,507,28995881,2020-04-14,0.945948009933278,0.0127819141836587
Texas,2020-04-21,823,26,20574,533,28995881,2020-04-15,0.97281119468943,0.013035867894815
Texas,2020-04-22,747,23,21321,556,28995881,2020-04-16,0.954205630090402,0.0129670965410438
Texas,2020-04-23,1329,48,22650,604,28995881,2020-04-17,1.02606117013761,0.0135019737204889
Texas,2020-04-24,992,20,23642,624,28995881,2020-04-18,1.03060009562962,0.0135394472006467
Texas,2020-04-25,511,14,24153,638,28995881,2020-04-19,0.962510856353583,0.0130378921904719
Texas,2020-04-26,814,13,24967,651,28995881,2020-04-20,1.01025953790064,0.0133718340168929
Texas,2020-04-27,354,15,25321,666,28995881,2020-04-21,0.988869557369548,0.0132486744306144
Texas,2020-04-28,1036,53,26357,719,28995881,2020-04-22,1.02659905126474,0.0134985374704532
Texas,2020-04-29,900,35,27257,754,28995881,2020-04-23,1.05154580361207,0.0136472350042022
Texas,2020-04-30,1470,58,28727,812,28995881,2020-04-24,1.06631697240997,0.013677476396883
Texas,2020-05-01,965,28,29692,840,28995881,2020-04-25,1.04742033174561,0.0134650330393321
Texas,2020-05-02,1225,23,30917,863,28995881,2020-04-26,1.15678007929188,0.014064260460404
Texas,2020-05-03,1081,15,31998,878,28995881,2020-04-27,1.17370371827683,0.0139964871379844
Texas,2020-05-04,785,23,32783,901,28995881,2020-04-28,1.20019974518635,0.0138930247505912
Texas,2020-05-05,1129,24,33912,925,28995881,2020-04-29,1.1667153683042,0.0134220528311378
Texas,2020-05-06,1016,29,34928,954,28995881,2020-04-30,1.13939039399964,0.0130082314816352
Texas,2020-05-07,1108,31,36036,985,28995881,2020-05-01,1.05138183812176,0.0122970738766509
Texas,2020-05-08,1210,40,37246,1025,28995881,2020-05-02,1.06646032098939,0.0122695170163836
Texas,2020-05-09,1148,41,38394,1066,28995881,2020-05-03,1.04266642327067,0.0120573719359408
Texas,2020-05-10,864,28,39258,1094,28995881,2020-05-04,1.00055675349369,0.0117420387511765
Utah,2020-03-08,0,0,1,0,3205958,2020-03-02,6.05747589181412,4.2832822799758
Utah,2020-03-09,0,0,1,0,3205958,2020-03-03,3.66070465155515,2.58850908303578
Utah,2020-03-10,1,0,2,0,3205958,2020-03-04,4.23255620446024,2.44366746400534
Utah,2020-03-11,1,0,3,0,3205958,2020-03-05,4.16216408729458,2.08108204364729
Utah,2020-03-12,0,0,3,0,3205958,2020-03-06,2.85894173608042,1.42947086804021
Utah,2020-03-13,6,0,9,0,3205958,2020-03-07,5.41512658480896,1.71241338261253
Utah,2020-03-14,1,0,10,0,3205958,2020-03-08,3.37378151330481,1.06688339098129
Utah,2020-03-15,8,0,18,0,3205958,2020-03-09,3.98775983085069,0.939924006045946
Utah,2020-03-16,10,0,28,0,3205958,2020-03-10,4.16679025884457,0.787449342162084
Utah,2020-03-17,11,0,39,0,3205958,2020-03-11,3.57610929548411,0.580121532032362
Utah,2020-03-18,8,0,47,0,3205958,2020-03-12,2.80430166089938,0.418040609545772
Utah,2020-03-19,15,0,62,0,3205958,2020-03-13,2.70087462286724,0.348681414485302
Utah,2020-03-20,33,0,95,0,3205958,2020-03-14,2.93607960859975,0.314780775166144
Utah,2020-03-21,23,0,118,0,3205958,2020-03-15,2.69172792186078,0.257820775622196
Utah,2020-03-22,44,1,162,1,3205958,2020-03-16,2.64999632952768,0.220070216796276
Utah,2020-03-23,95,0,257,1,3205958,2020-03-17,3.16390739303735,0.20862187546014
Utah,2020-03-24,41,0,298,1,3205958,2020-03-18,2.56081815168616,0.15881519988781
Utah,2020-03-25,42,0,340,1,3205958,2020-03-19,2.14341879337403,0.125006722591866
Utah,2020-03-26,56,0,396,1,3205958,2020-03-20,1.94859715163855,0.106463235324421
Utah,2020-03-27,76,0,472,1,3205958,2020-03-21,1.82259376602613,0.0937441079059521
Utah,2020-03-28,130,0,602,1,3205958,2020-03-22,1.98357875071332,0.0900696713178296
Utah,2020-03-29,118,1,720,2,3205958,2020-03-23,1.91824047000152,0.0811329272225453
Utah,2020-03-30,78,2,798,4,3205958,2020-03-24,1.55319781150794,0.0667155586017564
Utah,2020-03-31,90,1,888,5,3205958,2020-03-25,1.48214615275969,0.0609673460926223
Utah,2020-04-01,0,0,888,5,3205958,2020-03-26,1.24623324980258,0.0531879389911186
Utah,2020-04-02,198,2,1086,7,3205958,2020-03-27,1.46318529883376,0.0556621920327077
Utah,2020-04-03,162,0,1248,7,3205958,2020-03-28,1.52468030158052,0.0546976011373185
Utah,2020-04-04,180,1,1428,8,3205958,2020-03-29,1.46193361233519,0.0508364126856586
Utah,2020-04-05,173,0,1601,8,3205958,2020-03-30,1.41229727238205,0.0475545227786957
Utah,2020-04-06,77,5,1678,13,3205958,2020-03-31,1.2921730241599,0.0435344153182471
Utah,2020-04-07,61,0,1739,13,3205958,2020-04-01,1.16517093634806,0.0399180985302433
Utah,2020-04-08,109,0,1848,13,3205958,2020-04-02,1.2570761893677,0.0405508448183129
Utah,2020-04-09,8,0,1856,13,3205958,2020-04-03,0.963491381501248,0.0346992945245603
Utah,2020-04-10,247,4,2103,17,3205958,2020-04-04,1.04999457693233,0.0358880758121578
Utah,2020-04-11,104,1,2207,18,3205958,2020-04-05,0.956922813305831,0.0342633329957982
Utah,2020-04-12,96,0,2303,18,3205958,2020-04-06,0.862383689874389,0.0325254168817332
Utah,2020-04-13,60,-5,2363,13,3205958,2020-04-07,0.861574362750034,0.0328950620269257
Utah,2020-04-14,54,5,2417,18,3205958,2020-04-08,0.881087443287652,0.0338130327271588
Utah,2020-04-15,131,2,2548,20,3205958,2020-04-09,0.936547279223559,0.0353729025422969
Utah,2020-04-16,135,0,2683,20,3205958,2020-04-10,1.12823742672742,0.0392089609918883
Utah,2020-04-17,110,3,2793,23,3205958,2020-04-11,0.931207253261252,0.0354247934247233
Utah,2020-04-18,124,2,2917,25,3205958,2020-04-12,0.953880410399573,0.0357733102890303
Utah,2020-04-19,152,2,3069,27,3205958,2020-04-13,1.04457877543338,0.0377175535216468
Utah,2020-04-20,144,1,3213,28,3205958,2020-04-14,1.1569171887566,0.0396586104626894
Utah,2020-04-21,84,4,3297,32,3205958,2020-04-15,1.16824792773178,0.039359272736422
Utah,2020-04-22,148,0,3445,32,3205958,2020-04-16,1.14847896919718,0.0383252395899951
Utah,2020-04-23,167,3,3612,35,3205958,2020-04-17,1.15021357575228,0.0377169889823894
Utah,2020-04-24,170,4,3782,39,3205958,2020-04-18,1.18599291172867,0.0376933290814579
Utah,2020-04-25,166,2,3948,41,3205958,2020-04-19,1.19164683781183,0.037094345800606
Utah,2020-04-26,175,0,4123,41,3205958,2020-04-20,1.16948497920458,0.0360054645218771
Utah,2020-04-27,113,0,4236,41,3205958,2020-04-21,1.09263602162252,0.0341448756757037
Utah,2020-04-28,109,0,4345,41,3205958,2020-04-22,1.09017689616341,0.0336596216352148
Utah,2020-04-29,152,4,4497,45,3205958,2020-04-23,1.07379285833201,0.033090728290112
Utah,2020-04-30,175,1,4672,46,3205958,2020-04-24,1.06318173731108,0.032639974891761
Utah,2020-05-01,156,0,4828,46,3205958,2020-04-25,1.03410251252724,0.0319587844414538
Utah,2020-05-02,157,3,4985,49,3205958,2020-04-26,1.01514778354451,0.031508707889509
Utah,2020-05-03,190,1,5175,50,3205958,2020-04-27,1.02508999164756,0.0315898677508567
Utah,2020-05-04,142,0,5317,50,3205958,2020-04-28,1.04879718990818,0.0318843732629754
Utah,2020-05-05,132,6,5449,56,3205958,2020-04-29,1.06195055233597,0.0319464905500992
Utah,2020-05-06,146,2,5595,58,3205958,2020-04-30,1.04305331099832,0.03146354548997
Utah,2020-05-07,129,3,5724,61,3205958,2020-05-01,0.988340448760555,0.0304573689369339
Utah,2020-05-08,195,0,5919,61,3205958,2020-05-02,1.02287369121648,0.0309535660183389
Utah,2020-05-09,184,5,6103,66,3205958,2020-05-03,1.04693453154205,0.0312971276570966
Utah,2020-05-10,148,1,6251,67,3205958,2020-05-04,0.999157979124724,0.0304457242272541
Vermont,2020-03-08,1,0,1,0,623989,2020-03-02,10,7.07106781186548
Vermont,2020-03-09,0,0,1,0,623989,2020-03-03,6.05747589181412,4.2832822799758
Vermont,2020-03-10,0,0,1,0,623989,2020-03-04,3.66070465155515,2.58850908303578
Vermont,2020-03-11,0,0,1,0,623989,2020-03-05,2.82170413630682,1.99524612928469
Vermont,2020-03-12,1,0,2,0,623989,2020-03-06,3.61068188129305,2.08462815612265
Vermont,2020-03-13,0,0,2,0,623989,2020-03-07,2.84960848504645,1.64522222592661
Vermont,2020-03-14,3,0,5,0,623989,2020-03-08,4.48468245640409,1.83086394610025
Vermont,2020-03-15,0,0,5,0,623989,2020-03-09,2.5737991757061,1.15103798346235
Vermont,2020-03-16,7,0,12,0,623989,2020-03-10,4.57664585961256,1.32116385951645
Vermont,2020-03-17,0,0,12,0,623989,2020-03-11,3.05703807429714,0.882490877559196
Vermont,2020-03-18,1,0,13,0,623989,2020-03-12,2.26746319983639,0.628881140941366
Vermont,2020-03-19,9,2,22,2,623989,2020-03-13,2.90775999207892,0.634525250784087
Vermont,2020-03-20,7,0,29,2,623989,2020-03-14,2.94719751363358,0.55696797754731
Vermont,2020-03-21,20,0,49,2,623989,2020-03-15,3.44278833824448,0.51322058376388
Vermont,2020-03-22,3,0,52,2,623989,2020-03-16,2.5538535288396,0.368617005586604
Vermont,2020-03-23,23,3,75,5,623989,2020-03-17,2.50987026400725,0.313733783000907
Vermont,2020-03-24,20,2,95,7,623989,2020-03-18,2.54737166394842,0.277941035076886
Vermont,2020-03-25,30,1,125,8,623989,2020-03-19,2.62241009720035,0.246695590389623
Vermont,2020-03-26,33,1,158,9,623989,2020-03-20,2.41055898004721,0.205947952398123
Vermont,2020-03-27,26,1,184,10,623989,2020-03-21,2.11619345367043,0.169431075415329
Vermont,2020-03-28,27,2,211,12,623989,2020-03-22,1.77716943206345,0.139198652906286
Vermont,2020-03-29,24,0,235,12,623989,2020-03-23,1.6973139807035,0.12512764676199
Vermont,2020-03-30,21,0,256,12,623989,2020-03-24,1.46174118500216,0.108351465451824
Vermont,2020-03-31,37,1,293,13,623989,2020-03-25,1.43335883183551,0.10160811359209
Vermont,2020-04-01,28,3,321,16,623989,2020-03-26,1.2996748969786,0.092598002353066
Vermont,2020-04-02,17,1,338,17,623989,2020-03-27,1.11109025405068,0.0825866881788149
Vermont,2020-04-03,51,0,389,17,623989,2020-03-28,1.21824738951442,0.0848793175849276
Vermont,2020-04-04,72,3,461,20,623989,2020-03-29,1.43338972187462,0.090474756990518
Vermont,2020-04-05,51,2,512,22,623989,2020-03-30,1.47522943634077,0.0884783819031254
Vermont,2020-04-06,31,1,543,23,623989,2020-03-31,1.38924181332164,0.0818618589089692
Vermont,2020-04-07,32,0,575,23,623989,2020-04-01,1.25232906197367,0.0744432356483416
Vermont,2020-04-08,30,0,605,23,623989,2020-04-02,1.18481976712226,0.070182665940166
Vermont,2020-04-09,23,0,628,23,623989,2020-04-03,1.15864249623393,0.0679208260041288
Vermont,2020-04-10,51,1,679,24,623989,2020-04-04,1.11858888036698,0.0655728414593034
Vermont,2020-04-11,32,1,711,25,623989,2020-04-05,0.937905763659159,0.0592000868654832
Vermont,2020-04-12,16,2,727,27,623989,2020-04-06,0.805901147158472,0.0548346276017187
Vermont,2020-04-13,21,1,748,28,623989,2020-04-07,0.79525143434255,0.0554077928969217
Vermont,2020-04-14,4,1,752,29,623989,2020-04-08,0.721111287149382,0.0540495761011056
Vermont,2020-04-15,7,0,759,29,623989,2020-04-09,0.665671260186281,0.0534680022876506
Vermont,2020-04-16,15,4,774,33,623989,2020-04-10,0.680479832776981,0.0561250306617002
Vermont,2020-04-17,5,2,779,35,623989,2020-04-11,0.505966408154225,0.050345539311042
Vermont,2020-04-18,24,3,803,38,623989,2020-04-12,0.515650931164778,0.0534705106960638
Vermont,2020-04-19,10,0,813,38,623989,2020-04-13,0.545820802409123,0.0585181324038044
Vermont,2020-04-20,3,0,816,38,623989,2020-04-14,0.486213487968522,0.0585332255308979
Vermont,2020-04-21,2,2,818,40,623989,2020-04-15,0.532913525936083,0.0651057493535707
Vermont,2020-04-22,5,0,823,40,623989,2020-04-16,0.584702682624434,0.0725234420529198
Vermont,2020-04-23,2,3,825,43,623989,2020-04-17,0.521398405854267,0.0723049495097209
Vermont,2020-04-24,2,1,827,44,623989,2020-04-18,0.549271184275646,0.078467312039378
Vermont,2020-04-25,16,2,843,46,623989,2020-04-19,0.516551829883717,0.0806718424833834
Vermont,2020-04-26,8,0,851,46,623989,2020-04-20,0.552532784123442,0.0884760546384715
Vermont,2020-04-27,4,1,855,47,623989,2020-04-21,0.637220897819153,0.100753470488297
Vermont,2020-04-28,7,0,862,47,623989,2020-04-22,0.792310619376809,0.118110693614767
Vermont,2020-04-29,0,0,862,47,623989,2020-04-23,0.753667861956317,0.119165352152566
Vermont,2020-04-30,4,2,866,49,623989,2020-04-24,0.836360339568348,0.129053202170829
Vermont,2020-05-01,13,1,879,50,623989,2020-04-25,1.11018457946419,0.152495579922339
Vermont,2020-05-02,7,1,886,51,623989,2020-04-26,0.925411927020581,0.139511097202137
Vermont,2020-05-03,11,2,897,53,623989,2020-04-27,0.988820314390215,0.144234266751474
Vermont,2020-05-04,5,-1,902,52,623989,2020-04-28,1.02464594188589,0.147894902592969
Vermont,2020-05-05,5,0,907,52,623989,2020-04-29,0.982586613497147,0.144874492385635
Vermont,2020-05-06,1,0,908,52,623989,2020-04-30,1.00749190205949,0.146957797728104
Vermont,2020-05-07,8,1,916,53,623989,2020-05-01,1.09865992847339,0.153843161696093
Vermont,2020-05-08,3,0,919,53,623989,2020-05-02,0.874458697673013,0.136567504431806
Vermont,2020-05-09,2,0,921,53,623989,2020-05-03,0.775728150845728,0.129288025140955
Vermont,2020-05-10,6,0,927,53,623989,2020-05-04,0.701130215280929,0.125926704075629
Virgin Islands,2020-03-08,0,0,0,0,107268,2020-03-02,5,5
Virgin Islands,2020-03-09,0,0,0,0,107268,2020-03-03,5,5
Virgin Islands,2020-03-10,0,0,0,0,107268,2020-03-04,5,5
Virgin Islands,2020-03-11,0,0,0,0,107268,2020-03-05,5,5
Virgin Islands,2020-03-12,0,0,0,0,107268,2020-03-06,5,5
Virgin Islands,2020-03-13,0,0,0,0,107268,2020-03-07,5,5
Virgin Islands,2020-03-14,0,0,0,0,107268,2020-03-08,5,5
Virgin Islands,2020-03-15,0,0,0,0,107268,2020-03-09,5,5
Virgin Islands,2020-03-16,1,0,1,0,107268,2020-03-10,10,7.07106781186548
Virgin Islands,2020-03-17,1,0,2,0,107268,2020-03-11,9.08621383772119,5.24592800512283
Virgin Islands,2020-03-18,0,0,2,0,107268,2020-03-12,4.43450178540148,2.56026079952342
Virgin Islands,2020-03-19,1,0,3,0,107268,2020-03-13,3.79098612527967,1.89549306263984
Virgin Islands,2020-03-20,0,0,3,0,107268,2020-03-14,2.72140306405753,1.36070153202876
Virgin Islands,2020-03-21,3,0,6,0,107268,2020-03-15,3.68456624415252,1.3926351387387
Virgin Islands,2020-03-22,0,0,6,0,107268,2020-03-16,2.67844852193114,1.01235838407405
Virgin Islands,2020-03-23,1,0,7,0,107268,2020-03-17,1.99726570995295,0.754895481521768
Virgin Islands,2020-03-24,10,0,17,0,107268,2020-03-18,3.8326914657994,0.95817286644985
Virgin Islands,2020-03-25,0,0,17,0,107268,2020-03-19,2.73527573271395,0.683818933178487
Virgin Islands,2020-03-26,0,0,17,0,107268,2020-03-20,1.83524114423109,0.473857225858777
Virgin Islands,2020-03-27,2,0,19,0,107268,2020-03-21,1.73656624603919,0.421179179900113
Virgin Islands,2020-03-28,3,0,22,0,107268,2020-03-22,1.5252244439296,0.369921263829159
Virgin Islands,2020-03-29,1,0,23,0,107268,2020-03-23,1.45138360311974,0.342094395956312
Virgin Islands,2020-03-30,7,0,30,0,107268,2020-03-24,1.7809400693702,0.36353286936949
Virgin Islands,2020-03-31,0,0,30,0,107268,2020-03-25,0.922111634405043,0.246444700592987
Virgin Islands,2020-04-01,0,0,30,0,107268,2020-03-26,0.881980976812673,0.235719331206088
Virgin Islands,2020-04-02,0,0,30,0,107268,2020-03-27,0.920509530431357,0.246016520295307
Virgin Islands,2020-04-03,7,0,37,0,107268,2020-03-28,1.29166522467038,0.296328325432839
Virgin Islands,2020-04-04,3,0,40,0,107268,2020-03-29,1.26790471054398,0.290877289647389
Virgin Islands,2020-04-05,2,1,42,1,107268,2020-03-30,1.26708457834573,0.28332872504227
Virgin Islands,2020-04-06,1,0,43,1,107268,2020-03-31,0.847724400579362,0.226563876098306
Virgin Islands,2020-04-07,0,0,43,1,107268,2020-04-01,0.85360071211375,0.228134386416851
Virgin Islands,2020-04-08,2,0,45,1,107268,2020-04-02,1.02527546212834,0.256318865532085
Virgin Islands,2020-04-09,0,0,45,1,107268,2020-04-03,1.04793885192039,0.261984712980097
Virgin Islands,2020-04-10,5,0,50,1,107268,2020-04-04,0.917963540983961,0.2453360759937
Virgin Islands,2020-04-11,1,0,51,1,107268,2020-04-05,0.801169852626782,0.231277815040343
Virgin Islands,2020-04-12,0,0,51,1,107268,2020-04-06,0.700483257672141,0.221512255705858
Virgin Islands,2020-04-13,0,0,51,1,107268,2020-04-07,0.679189055935731,0.226396351978577
Virgin Islands,2020-04-14,0,0,51,1,107268,2020-04-08,0.742933659939359,0.24764455331312
Virgin Islands,2020-04-15,0,0,51,1,107268,2020-04-09,0.628288138259503,0.237470595075201
Virgin Islands,2020-04-16,0,0,51,1,107268,2020-04-10,0.689652254866715,0.260664051070323
Virgin Islands,2020-04-17,0,1,51,2,107268,2020-04-11,0.218141341251604,0.154249221656138
Virgin Islands,2020-04-18,2,1,53,3,107268,2020-04-12,0.385613619544639,0.222634127047283
Virgin Islands,2020-04-19,0,0,53,3,107268,2020-04-13,0.47810692742866,0.276035163252362
Virgin Islands,2020-04-20,0,0,53,3,107268,2020-04-14,0.570116778106855,0.329157075309515
Virgin Islands,2020-04-21,0,0,53,3,107268,2020-04-15,0.666506192210214,0.38480752948912
Virgin Islands,2020-04-22,1,0,54,3,107268,2020-04-16,1.01801583327577,0.509007916637886
Virgin Islands,2020-04-23,0,0,54,3,107268,2020-04-17,1.10203947183516,0.551019735917578
Virgin Islands,2020-04-24,0,0,54,3,107268,2020-04-18,1.13544101352378,0.567720506761888
Virgin Islands,2020-04-25,1,0,55,3,107268,2020-04-19,0.871428777110037,0.503119639044066
Virgin Islands,2020-04-26,2,1,57,4,107268,2020-04-20,1.53744233154293,0.687565112963153
Virgin Islands,2020-04-27,0,0,57,4,107268,2020-04-21,1.53798298036746,0.687806898467871
Virgin Islands,2020-04-28,0,0,57,4,107268,2020-04-22,1.43395633738605,0.641284769432367
Virgin Islands,2020-04-29,0,0,57,4,107268,2020-04-23,1.09167657951049,0.545838289755243
Virgin Islands,2020-04-30,9,0,66,4,107268,2020-04-24,3.54503130827366,0.98321478116199
Virgin Islands,2020-05-01,0,0,66,4,107268,2020-04-25,2.75274829548638,0.763475009832481
Virgin Islands,2020-05-02,0,0,66,4,107268,2020-04-26,1.82346754071181,0.526389737744254
Virgin Islands,2020-05-03,0,0,66,4,107268,2020-04-27,1.27434318786492,0.4029826994373
Virgin Islands,2020-05-04,0,0,66,4,107268,2020-04-28,1.18763567297603,0.375563375707114
Virgin Islands,2020-05-05,0,0,66,4,107268,2020-04-29,1.16091220449702,0.367112672969776
Virgin Islands,2020-05-06,0,0,66,4,107268,2020-04-30,1.14160841317194,0.361008278163389
Virgin Islands,2020-05-07,0,0,66,4,107268,2020-05-01,0.112751931837601,0.112751931837601
Virgin Islands,2020-05-08,2,0,68,4,107268,2020-05-02,0.385616650339929,0.22263587687776
Virgin Islands,2020-05-09,0,0,68,4,107268,2020-05-03,0.487301820063353,0.281343836990172
Virgin Islands,2020-05-10,1,0,69,4,107268,2020-05-04,0.773229805988153,0.386614902994076
Virginia,2020-03-08,2,0,2,0,8535519,2020-03-02,15,8.66025403784439
Virginia,2020-03-09,0,0,2,0,8535519,2020-03-03,6.51690738866037,3.76253823512692
Virginia,2020-03-10,6,0,8,0,8535519,2020-03-04,10.0819347350656,3.36064491168852
Virginia,2020-03-11,1,0,9,0,8535519,2020-03-05,5.00348687930751,1.58224147813797
Virginia,2020-03-12,3,0,12,0,8535519,2020-03-06,3.54226916164223,0.98244869952276
Virginia,2020-03-13,15,0,27,0,8535519,2020-03-07,5.15196926636293,0.9736306743603
Virginia,2020-03-14,10,1,37,1,8535519,2020-03-08,4.19024830088059,0.679748034259612
Virginia,2020-03-15,0,0,37,1,8535519,2020-03-09,2.41993604213632,0.403322673689386
Virginia,2020-03-16,12,1,49,2,8535519,2020-03-10,2.3804800450331,0.343592698700098
Virginia,2020-03-17,18,0,67,2,8535519,2020-03-11,2.35637558483875,0.304206779916341
Virginia,2020-03-18,12,0,79,2,8535519,2020-03-12,2.18952939393699,0.259849332480072
Virginia,2020-03-19,24,0,103,2,8535519,2020-03-13,2.27089737423331,0.236757417686004
Virginia,2020-03-20,20,0,123,2,8535519,2020-03-14,1.91608010463838,0.19454845863334
Virginia,2020-03-21,34,1,157,3,8535519,2020-03-15,1.97199919289833,0.179272653899848
Virginia,2020-03-22,63,3,220,6,8535519,2020-03-16,2.51565754353751,0.185456734617497
Virginia,2020-03-23,34,0,254,6,8535519,2020-03-17,2.21415720268007,0.154267642193878
Virginia,2020-03-24,39,3,293,9,8535519,2020-03-18,1.91870767482594,0.127349101192775
Virginia,2020-03-25,103,0,396,9,8535519,2020-03-19,2.22943843191819,0.125020699188235
Virginia,2020-03-26,70,1,466,10,8535519,2020-03-20,2.07703657045138,0.108866297106054
Virginia,2020-03-27,141,0,607,10,8535519,2020-03-21,2.24002537928178,0.101714312871597
Virginia,2020-03-28,133,3,740,13,8535519,2020-03-22,2.17326188610632,0.0899302167208338
Virginia,2020-03-29,150,7,890,20,8535519,2020-03-23,2.0020353118741,0.0772877159916465
Virginia,2020-03-30,130,-5,1020,15,8535519,2020-03-24,1.87931421896345,0.0678581034813169
Virginia,2020-03-31,229,12,1249,27,8535519,2020-03-25,1.97012933139733,0.0636852367981109
Virginia,2020-04-01,234,7,1483,34,8535519,2020-03-26,1.87526623768812,0.0568523586334025
Virginia,2020-04-02,223,7,1706,41,8535519,2020-03-27,1.79676680421351,0.0510041864323015
Virginia,2020-04-03,306,5,2012,46,8535519,2020-03-28,1.73763852730259,0.0463411467908762
Virginia,2020-04-04,395,6,2407,52,8535519,2020-03-29,1.77872675023587,0.0435523118572173
Virginia,2020-04-05,233,0,2640,52,8535519,2020-03-30,1.60933625998877,0.0384595079380439
Virginia,2020-04-06,238,14,2878,66,8535519,2020-03-31,1.495854190263,0.0346936160152676
Virginia,2020-04-07,457,0,3335,66,8535519,2020-04-01,1.50910932427616,0.0330338717182569
Virginia,2020-04-08,310,0,3645,66,8535519,2020-04-02,1.41305316069592,0.0303829711393277
Virginia,2020-04-09,397,43,4042,109,8535519,2020-04-03,1.39217493892949,0.0287981411094165
Virginia,2020-04-10,467,12,4509,121,8535519,2020-04-04,1.37140728001096,0.0274391234456058
Virginia,2020-04-11,568,9,5077,130,8535519,2020-04-05,1.35558844410927,0.0262295544794925
Virginia,2020-04-12,197,11,5274,141,8535519,2020-04-06,1.24069319416973,0.0241698575123363
Virginia,2020-04-13,473,8,5747,149,8535519,2020-04-07,1.27277455189259,0.0237580359406659
Virginia,2020-04-14,435,5,6182,154,8535519,2020-04-08,1.19675584893739,0.0224251608192429
Virginia,2020-04-15,318,41,6500,195,8535519,2020-04-09,1.14306827680573,0.0213891275608659
Virginia,2020-04-16,389,13,6889,208,8535519,2020-04-10,1.10121678666112,0.0206349219514176
Virginia,2020-04-17,602,23,7491,231,8535519,2020-04-11,1.1247971005811,0.0205943249726228
Virginia,2020-04-18,562,27,8053,258,8535519,2020-04-12,1.09524628862783,0.0200734662832255
Virginia,2020-04-19,489,19,8542,277,8535519,2020-04-13,1.17464797867074,0.0205447223027812
Virginia,2020-04-20,448,23,8990,300,8535519,2020-04-14,1.13070938275386,0.019852288287784
Virginia,2020-04-21,640,24,9630,324,8535519,2020-04-15,1.16325639680548,0.0198074629494034
Virginia,2020-04-22,636,25,10266,349,8535519,2020-04-16,1.2307286964866,0.0200523149365008
Virginia,2020-04-23,732,24,10998,373,8535519,2020-04-17,1.284992143651,0.0200437769631891
Virginia,2020-04-24,596,38,11594,411,8535519,2020-04-18,1.21269173106876,0.0189298311523574
Virginia,2020-04-25,772,26,12366,437,8535519,2020-04-19,1.2105724577229,0.0184310772117441
Virginia,2020-04-26,604,12,12970,449,8535519,2020-04-20,1.18898015723996,0.0178657711504755
Virginia,2020-04-27,568,11,13538,460,8535519,2020-04-21,1.17055775798265,0.0173554100570603
Virginia,2020-04-28,801,32,14339,492,8535519,2020-04-22,1.16685075707201,0.0170021897508121
Virginia,2020-04-29,623,30,14962,522,8535519,2020-04-23,1.122440669835,0.0163777076385577
Virginia,2020-04-30,885,30,15847,552,8535519,2020-04-24,1.12442750751149,0.0161458380558416
Virginia,2020-05-01,1055,29,16902,581,8535519,2020-04-25,1.19885827301603,0.0164536207179305
Virginia,2020-05-02,836,36,17738,617,8535519,2020-04-26,1.16989710457561,0.0159602336837405
Virginia,2020-05-03,934,43,18672,660,8535519,2020-04-27,1.19338144107227,0.0158025653074299
Virginia,2020-05-04,821,24,19493,684,8535519,2020-04-28,1.1985656769761,0.0155304661806824
Virginia,2020-05-05,764,29,20257,713,8535519,2020-04-29,1.14170419954757,0.0148398471772701
Virginia,2020-05-06,728,24,20985,737,8535519,2020-04-30,1.12155561671006,0.0144503488964591
Virginia,2020-05-07,585,32,21570,769,8535519,2020-05-01,1.03681693862326,0.0137041552879102
Virginia,2020-05-08,772,43,22342,812,8535519,2020-05-02,0.970469627633889,0.0131565671011245
Virginia,2020-05-09,854,15,23196,827,8535519,2020-05-03,0.9750456236444,0.0131967925640438
Virginia,2020-05-10,885,12,24081,839,8535519,2020-05-04,0.972730897064148,0.0132249511989653
Washington,2020-03-08,20,2,122,18,7614893,2020-03-02,2.49690934022287,0.235935755732289
Washington,2020-03-09,0,1,122,19,7614893,2020-03-03,1.76619172021907,0.172362662860288
Washington,2020-03-10,45,4,167,23,7614893,2020-03-04,1.97479503811992,0.166307743506532
Washington,2020-03-11,115,1,282,24,7614893,2020-03-05,2.89657066000835,0.185433934906319
Washington,2020-03-12,160,7,442,31,7614893,2020-03-06,3.34370060961365,0.173130254910855
Washington,2020-03-13,126,6,568,37,7614893,2020-03-07,3.04850972631184,0.137577318023937
Washington,2020-03-14,74,2,642,39,7614893,2020-03-08,2.36352977223811,0.101616081734224
Washington,2020-03-15,-39,1,603,40,7614893,2020-03-09,1.73467927114257,0.0759976786913366
Washington,2020-03-16,176,8,779,48,7614893,2020-03-10,1.95046856165192,0.0738792648982905
Washington,2020-03-17,176,7,955,55,7614893,2020-03-11,1.96799882611078,0.06839268701525
Washington,2020-03-18,67,12,1022,67,7614893,2020-03-12,1.54075790424013,0.055167982626009
Washington,2020-03-19,352,6,1374,73,7614893,2020-03-13,1.67655309895839,0.053775465721907
Washington,2020-03-20,150,10,1524,83,7614893,2020-03-14,1.52219373194827,0.0482325540965989
Washington,2020-03-21,269,11,1793,94,7614893,2020-03-15,1.61777772703445,0.0468773411872213
Washington,2020-03-22,204,3,1997,97,7614893,2020-03-16,1.68897049083837,0.0452204581395773
Washington,2020-03-23,224,12,2221,109,7614893,2020-03-17,1.53017907631993,0.0402818208440355
Washington,2020-03-24,107,7,2328,116,7614893,2020-03-18,1.29451444389754,0.0349231600420298
Washington,2020-03-25,263,17,2591,133,7614893,2020-03-19,1.36872005794325,0.034543378037655
Washington,2020-03-26,616,17,3207,150,7614893,2020-03-20,1.49254686603316,0.0348520486194018
Washington,2020-03-27,270,7,3477,157,7614893,2020-03-21,1.44983323750936,0.03279863517103
Washington,2020-03-28,553,31,4030,188,7614893,2020-03-22,1.50807689928862,0.0318781747033364
Washington,2020-03-29,435,10,4465,198,7614893,2020-03-23,1.50771057425834,0.0303429244518282
Washington,2020-03-30,458,7,4923,205,7614893,2020-03-24,1.48788698928388,0.0286185037048186
Washington,2020-03-31,509,20,5432,225,7614893,2020-03-25,1.54550652455793,0.0277357580778268
Washington,2020-04-01,176,9,5608,234,7614893,2020-03-26,1.35115646756347,0.0245949546825734
Washington,2020-04-02,781,37,6389,271,7614893,2020-03-27,1.30521928072662,0.0231347686708042
Washington,2020-04-03,457,20,6846,291,7614893,2020-03-28,1.29419935890333,0.0222939092997442
Washington,2020-04-04,401,24,7247,315,7614893,2020-03-29,1.16090199825769,0.0204645660017594
Washington,2020-04-05,578,21,7825,336,7614893,2020-03-30,1.15871832080225,0.0199868161467865
Washington,2020-04-06,486,45,8311,381,7614893,2020-03-31,1.13045394954495,0.0194185631213482
Washington,2020-04-07,381,19,8692,400,7614893,2020-04-01,1.05479615975463,0.0184711162059976
Washington,2020-04-08,584,26,9276,426,7614893,2020-04-02,1.16526335819709,0.0192375709412602
Washington,2020-04-09,363,30,9639,456,7614893,2020-04-03,1.006664201182,0.0176553422103325
Washington,2020-04-10,480,27,10119,483,7614893,2020-04-04,0.996924824740801,0.0174230054751631
Washington,2020-04-11,315,12,10434,495,7614893,2020-04-05,0.972345972254665,0.0172211307145185
Washington,2020-04-12,175,11,10609,506,7614893,2020-04-06,0.852695098970268,0.0161577605213618
Washington,2020-04-13,26,7,10635,513,7614893,2020-04-07,0.727917362218117,0.0150963028475156
Washington,2020-04-14,164,17,10799,530,7614893,2020-04-08,0.69517959818233,0.0151412494647994
Washington,2020-04-15,143,22,10942,552,7614893,2020-04-09,0.58944552407658,0.0144369640273252
Washington,2020-04-16,115,27,11057,579,7614893,2020-04-10,0.547554912751748,0.0145357177754094
Washington,2020-04-17,460,24,11517,603,7614893,2020-04-11,0.6006159801494,0.0160578732559169
Washington,2020-04-18,259,10,11776,613,7614893,2020-04-12,0.639447979954545,0.0174488662392846
Washington,2020-04-19,202,23,11978,636,7614893,2020-04-13,0.714105380093668,0.0192931002734048
Washington,2020-04-20,136,7,12114,643,7614893,2020-04-14,0.832031311227536,0.0216276240848617
Washington,2020-04-21,278,21,12392,664,7614893,2020-04-15,0.942465700095545,0.023605945222492
Washington,2020-04-22,204,22,12596,686,7614893,2020-04-16,1.00094714251897,0.0246043640925124
Washington,2020-04-23,157,25,12753,711,7614893,2020-04-17,1.03073068127889,0.0250209780850181
Washington,2020-04-24,224,11,12977,722,7614893,2020-04-18,0.883415040389862,0.0231121145329486
Washington,2020-04-25,342,15,13319,737,7614893,2020-04-19,0.945137869023153,0.0240531254561834
Washington,2020-04-26,202,12,13521,749,7614893,2020-04-20,0.964199457529352,0.0245382301110288
Washington,2020-04-27,165,15,13686,764,7614893,2020-04-21,0.991251907331297,0.0249930739775138
Washington,2020-04-28,156,22,13842,786,7614893,2020-04-22,0.918470040759708,0.0241118919356722
Washington,2020-04-29,228,15,14070,801,7614893,2020-04-23,0.944283275498946,0.0245870422589226
Washington,2020-04-30,257,13,14327,814,7614893,2020-04-24,1.02448169800619,0.0258145123396339
Washington,2020-05-01,310,10,14637,824,7614893,2020-04-25,1.08230860888803,0.0265562223771283
Washington,2020-05-02,366,6,15003,830,7614893,2020-04-26,1.08311503050035,0.0263860651256772
Washington,2020-05-03,182,4,15185,834,7614893,2020-04-27,1.05061020217338,0.0257474660919601
Washington,2020-05-04,277,7,15462,841,7614893,2020-04-28,1.10585964001247,0.0262335034683777
Washington,2020-05-05,132,21,15594,862,7614893,2020-04-29,1.07170228023872,0.0255966539263263
Washington,2020-05-06,311,8,15905,870,7614893,2020-04-30,1.10104619111068,0.0256962175501196
Washington,2020-05-07,326,21,16231,891,7614893,2020-05-01,1.12101173732571,0.0256840005062744
Washington,2020-05-08,157,14,16388,905,7614893,2020-05-02,1.00568313669448,0.0240266995159539
Washington,2020-05-09,286,16,16674,921,7614893,2020-05-03,0.948669169338812,0.0232004629044263
Washington,2020-05-10,217,10,16891,931,7614893,2020-05-04,0.975844139506904,0.0236191191880327
West Virginia,2020-03-08,0,0,0,0,1792147,2020-03-02,5,5
West Virginia,2020-03-09,0,0,0,0,1792147,2020-03-03,5,5
West Virginia,2020-03-10,0,0,0,0,1792147,2020-03-04,5,5
West Virginia,2020-03-11,0,0,0,0,1792147,2020-03-05,5,5
West Virginia,2020-03-12,0,0,0,0,1792147,2020-03-06,5,5
West Virginia,2020-03-13,0,0,0,0,1792147,2020-03-07,5,5
West Virginia,2020-03-14,0,0,0,0,1792147,2020-03-08,5,5
West Virginia,2020-03-15,0,0,0,0,1792147,2020-03-09,5,5
West Virginia,2020-03-16,0,0,0,0,1792147,2020-03-10,5,5
West Virginia,2020-03-17,0,0,0,0,1792147,2020-03-11,5,5
West Virginia,2020-03-18,1,0,1,0,1792147,2020-03-12,10,7.07106781186548
West Virginia,2020-03-19,1,0,2,0,1792147,2020-03-13,9.08621383772119,5.24592800512283
West Virginia,2020-03-20,6,0,8,0,1792147,2020-03-14,13.3035053562044,4.43450178540148
West Virginia,2020-03-21,4,0,12,0,1792147,2020-03-15,7.08000232665065,1.9636393399341
West Virginia,2020-03-22,4,0,16,0,1792147,2020-03-16,4.31647475336865,1.04689890226182
West Virginia,2020-03-23,0,0,16,0,1792147,2020-03-17,2.61045424128695,0.633128151039278
West Virginia,2020-03-24,6,0,22,0,1792147,2020-03-18,2.57850545081098,0.537655553218826
West Virginia,2020-03-25,17,0,39,0,1792147,2020-03-19,3.38830196630478,0.542562538398531
West Virginia,2020-03-26,13,0,52,0,1792147,2020-03-20,3.13854283910486,0.439483903046726
West Virginia,2020-03-27,24,0,76,0,1792147,2020-03-21,2.96559861764625,0.357016119495321
West Virginia,2020-03-28,20,0,96,0,1792147,2020-03-22,2.63130328870494,0.285404913539249
West Virginia,2020-03-29,17,0,113,0,1792147,2020-03-23,2.26290126259613,0.228587546848189
West Virginia,2020-03-30,32,1,145,1,1792147,2020-03-24,2.35668484768573,0.206694934464213
West Virginia,2020-03-31,17,0,162,1,1792147,2020-03-25,2.02078021625911,0.170180394117583
West Virginia,2020-04-01,29,0,191,1,1792147,2020-03-26,1.77957963547467,0.14387048639726
West Virginia,2020-04-02,25,1,216,2,1792147,2020-03-27,1.63344567000025,0.127163572944041
West Virginia,2020-04-03,21,0,237,2,1792147,2020-03-28,1.40507271106965,0.110392938006391
West Virginia,2020-04-04,45,0,282,2,1792147,2020-03-29,1.47174983786956,0.107625007164758
West Virginia,2020-04-05,42,1,324,3,1792147,2020-03-30,1.5273934173628,0.104901810590235
West Virginia,2020-04-06,21,1,345,4,1792147,2020-03-31,1.30661040779629,0.0921611922774329
West Virginia,2020-04-07,67,0,412,4,1792147,2020-04-01,1.50607612890177,0.0950626823202
West Virginia,2020-04-08,71,0,483,4,1792147,2020-04-02,1.6143014386919,0.0943084970233028
West Virginia,2020-04-09,31,1,514,5,1792147,2020-04-03,1.46537977615495,0.0847451005551755
West Virginia,2020-04-10,60,0,574,5,1792147,2020-04-04,1.4907415881464,0.0810856527673173
West Virginia,2020-04-11,3,0,577,5,1792147,2020-04-05,1.1860368272141,0.0689369903134252
West Virginia,2020-04-12,16,1,593,6,1792147,2020-04-06,1.01549043148253,0.0618007795837375
West Virginia,2020-04-13,18,2,611,8,1792147,2020-04-07,0.98968323381835,0.0605676302993538
West Virginia,2020-04-14,29,1,640,9,1792147,2020-04-08,0.850517568926587,0.0562037829560533
West Virginia,2020-04-15,62,1,702,10,1792147,2020-04-09,0.834775577656397,0.0562805579643617
West Virginia,2020-04-16,26,2,728,12,1792147,2020-04-10,0.847829932601237,0.0578215214867677
West Virginia,2020-04-17,47,4,775,16,1792147,2020-04-11,0.826543015109306,0.058155363604488
West Virginia,2020-04-18,10,0,785,16,1792147,2020-04-12,0.888620817325932,0.061467187223684
West Virginia,2020-04-19,105,2,890,18,1792147,2020-04-13,1.30897892526275,0.0758271132022311
West Virginia,2020-04-20,12,6,902,24,1792147,2020-04-14,1.24569289345495,0.0728986626520176
West Virginia,2020-04-21,6,2,908,26,1792147,2020-04-15,1.07931572023811,0.0658070408983413
West Virginia,2020-04-22,31,1,939,27,1792147,2020-04-16,0.927267664561387,0.0601058352898211
West Virginia,2020-04-23,42,4,981,31,1792147,2020-04-17,0.994134105165445,0.0623775215371887
West Virginia,2020-04-24,29,1,1010,32,1792147,2020-04-18,0.93268169312985,0.0607124069601631
West Virginia,2020-04-25,0,0,1010,32,1792147,2020-04-19,0.901360669407083,0.0599576198540057
West Virginia,2020-04-26,45,2,1055,34,1792147,2020-04-20,0.675977591226985,0.0524660362796525
West Virginia,2020-04-27,8,0,1063,34,1792147,2020-04-21,0.696182620175933,0.0546972724078468
West Virginia,2020-04-28,32,4,1095,38,1792147,2020-04-22,0.872785866749489,0.0636544515164484
West Virginia,2020-04-29,15,0,1110,38,1792147,2020-04-23,0.837732403379257,0.0638764969183168
West Virginia,2020-04-30,15,3,1125,41,1792147,2020-04-24,0.729628932619336,0.0605923848245449
West Virginia,2020-05-01,27,5,1152,46,1792147,2020-04-25,0.759126372030024,0.0634813363195778
West Virginia,2020-05-02,33,2,1185,48,1792147,2020-04-26,0.993588293589003,0.0748945355891865
West Virginia,2020-05-03,10,0,1195,48,1792147,2020-04-27,0.816212908380113,0.0687375268791603
West Virginia,2020-05-04,29,0,1224,48,1792147,2020-04-28,0.959703165005735,0.0754014017668609
West Virginia,2020-05-05,22,0,1246,48,1792147,2020-04-29,0.924419686714047,0.0749803376500035
West Virginia,2020-05-06,-4,2,1242,50,1792147,2020-04-30,0.843992730275936,0.0721071652168523
West Virginia,2020-05-07,45,1,1287,51,1792147,2020-05-01,1.05960009543823,0.0819943171045492
West Virginia,2020-05-08,36,1,1323,52,1792147,2020-05-02,1.12682035263676,0.0849372799052747
West Virginia,2020-05-09,0,0,1323,52,1792147,2020-05-03,0.894585690861105,0.0748090136249273
West Virginia,2020-05-10,37,2,1360,54,1792147,2020-05-04,1.06670282807714,0.0818123722639642
Wisconsin,2020-03-08,0,0,0,0,5822434,2020-03-02,5,5
Wisconsin,2020-03-09,0,0,0,0,5822434,2020-03-03,5,5
Wisconsin,2020-03-10,3,0,3,0,5822434,2020-03-04,20,10
Wisconsin,2020-03-11,1,0,4,0,5822434,2020-03-05,8.46723450019719,3.78666238477447
Wisconsin,2020-03-12,4,0,8,0,5822434,2020-03-06,6.57318511852256,2.19106170617419
Wisconsin,2020-03-13,11,0,19,0,5822434,2020-03-07,7.71188519427015,1.72442995290622
Wisconsin,2020-03-14,8,0,27,0,5822434,2020-03-08,5.16734550511306,0.976536510348328
Wisconsin,2020-03-15,1,0,28,0,5822434,2020-03-09,2.93374176409591,0.544782169007931
Wisconsin,2020-03-16,20,0,48,0,5822434,2020-03-10,3.42218641523951,0.488883773605644
Wisconsin,2020-03-17,25,0,73,0,5822434,2020-03-11,3.48523527623816,0.413621330032963
Wisconsin,2020-03-18,38,0,111,0,5822434,2020-03-12,3.58192561516966,0.34467095302257
Wisconsin,2020-03-19,48,4,159,4,5822434,2020-03-13,3.38374212483129,0.274457728115079
Wisconsin,2020-03-20,60,-1,219,3,5822434,2020-03-14,3.03965116290249,0.214400462149276
Wisconsin,2020-03-21,63,1,282,4,5822434,2020-03-15,2.73366470937334,0.170854044335834
Wisconsin,2020-03-22,99,0,381,4,5822434,2020-03-16,2.7811088972043,0.147814270181313
Wisconsin,2020-03-23,44,1,425,5,5822434,2020-03-17,2.19980689442109,0.11314585769296
Wisconsin,2020-03-24,56,0,481,5,5822434,2020-03-18,1.85882806073108,0.091913132149432
Wisconsin,2020-03-25,140,2,621,7,5822434,2020-03-19,1.94203217387127,0.0859104453888486
Wisconsin,2020-03-26,107,3,728,10,5822434,2020-03-20,1.82424574655572,0.0764092460629365
Wisconsin,2020-03-27,198,4,926,14,5822434,2020-03-21,1.91723728045663,0.0720541893297088
Wisconsin,2020-03-28,129,3,1055,17,5822434,2020-03-22,1.77145397532969,0.0636735982540187
Wisconsin,2020-03-29,109,1,1164,18,5822434,2020-03-23,1.52919246265245,0.0546140165233019
Wisconsin,2020-03-30,66,2,1230,20,5822434,2020-03-24,1.39269622488484,0.0490556322514925
Wisconsin,2020-03-31,182,5,1412,25,5822434,2020-03-25,1.47372319713623,0.0482734083600569
Wisconsin,2020-04-01,144,2,1556,27,5822434,2020-03-26,1.35307999752912,0.0442268032746991
Wisconsin,2020-04-02,192,11,1748,38,5822434,2020-03-27,1.35810415474253,0.0425030608464988
Wisconsin,2020-04-03,264,13,2012,51,5822434,2020-03-28,1.3445798151305,0.0407823094128498
Wisconsin,2020-04-04,18,3,2030,54,5822434,2020-03-29,1.1222884379215,0.0359235774940582
Wisconsin,2020-04-05,290,20,2320,74,5822434,2020-03-30,1.27279940542008,0.0374190953988034
Wisconsin,2020-04-06,129,4,2449,78,5822434,2020-03-31,1.28552578197087,0.0368044960737027
Wisconsin,2020-04-07,129,14,2578,92,5822434,2020-04-01,1.15691664805149,0.0338662135518816
Wisconsin,2020-04-08,132,8,2710,100,5822434,2020-04-02,1.09569361217892,0.0322402304645399
Wisconsin,2020-04-09,176,11,2886,111,5822434,2020-04-03,1.05422210649176,0.0312370675584956
Wisconsin,2020-04-10,182,17,3068,128,5822434,2020-04-04,0.963825636810741,0.0296456502251052
Wisconsin,2020-04-11,145,9,3213,137,5822434,2020-04-05,1.07997841364888,0.0313862351202446
Wisconsin,2020-04-12,128,7,3341,144,5822434,2020-04-06,0.926665085459296,0.0289866049874408
Wisconsin,2020-04-13,87,10,3428,154,5822434,2020-04-07,0.889491239591498,0.0284137553873877
Wisconsin,2020-04-14,127,16,3555,170,5822434,2020-04-08,0.908696540013988,0.029056911257981
Wisconsin,2020-04-15,166,13,3721,183,5822434,2020-04-09,0.962083981787385,0.0302428508523868
Wisconsin,2020-04-16,154,14,3875,197,5822434,2020-04-10,0.953988329126062,0.030319739413287
Wisconsin,2020-04-17,178,9,4053,206,5822434,2020-04-11,0.958876381943468,0.0305368449656373
Wisconsin,2020-04-18,146,6,4199,212,5822434,2020-04-12,0.969498403232737,0.0308594741818287
Wisconsin,2020-04-19,147,8,4346,220,5822434,2020-04-13,0.996021984659805,0.0314029128634241
Wisconsin,2020-04-20,153,10,4499,230,5822434,2020-04-14,1.06500099886898,0.0325276450676833
Wisconsin,2020-04-21,126,14,4625,244,5822434,2020-04-15,1.05535733454254,0.0322481494134283
Wisconsin,2020-04-22,220,4,4845,248,5822434,2020-04-16,1.09360994330925,0.0326051489881223
Wisconsin,2020-04-23,207,10,5052,258,5822434,2020-04-17,1.12614628752788,0.0328112037900701
Wisconsin,2020-04-24,304,5,5356,263,5822434,2020-04-18,1.21600100511425,0.0336740333918648
Wisconsin,2020-04-25,331,3,5687,266,5822434,2020-04-19,1.33563890985031,0.034613196952823
Wisconsin,2020-04-26,225,6,5912,272,5822434,2020-04-20,1.32155994081992,0.0333850758740602
Wisconsin,2020-04-27,169,9,6081,281,5822434,2020-04-21,1.24543051774511,0.0313025015654014
Wisconsin,2020-04-28,208,19,6289,300,5822434,2020-04-22,1.23655615176486,0.0303044721272525
Wisconsin,2020-04-29,231,8,6520,308,5822434,2020-04-23,1.18383578718008,0.0289170813891546
Wisconsin,2020-04-30,334,8,6854,316,5822434,2020-04-24,1.21913494717986,0.0287113700969252
Wisconsin,2020-05-01,460,11,7314,327,5822434,2020-04-25,1.26859356517196,0.028661920439943
Wisconsin,2020-05-02,346,7,7660,334,5822434,2020-04-26,1.21204837841679,0.0272801265534718
Wisconsin,2020-05-03,304,5,7964,339,5822434,2020-04-27,1.19883099027039,0.02645839442915
Wisconsin,2020-05-04,272,1,8236,340,5822434,2020-04-28,1.20610354370122,0.025975278654383
Wisconsin,2020-05-05,330,13,8566,353,5822434,2020-04-29,1.22030426814626,0.0255676769545723
Wisconsin,2020-05-06,335,9,8901,362,5822434,2020-04-30,1.2188411747059,0.0249733174918447
Wisconsin,2020-05-07,314,12,9215,374,5822434,2020-05-01,1.15326555407883,0.0237295429809908
Wisconsin,2020-05-08,375,10,9590,384,5822434,2020-05-02,1.0698793154011,0.0224209120882337
Wisconsin,2020-05-09,349,14,9939,398,5822434,2020-05-03,1.04822791681976,0.021952717987021
Wisconsin,2020-05-10,280,2,10219,400,5822434,2020-05-04,1.02516760627175,0.0215836717259231
Wyoming,2020-03-08,0,0,0,0,578759,2020-03-02,5,5
Wyoming,2020-03-09,0,0,0,0,578759,2020-03-03,5,5
Wyoming,2020-03-10,0,0,0,0,578759,2020-03-04,5,5
Wyoming,2020-03-11,0,0,0,0,578759,2020-03-05,5,5
Wyoming,2020-03-12,1,0,1,0,578759,2020-03-06,10,7.07106781186548
Wyoming,2020-03-13,0,0,1,0,578759,2020-03-07,6.05747589181412,4.2832822799758
Wyoming,2020-03-14,1,0,2,0,578759,2020-03-08,5.49105697733272,3.17026322399862
Wyoming,2020-03-15,0,0,2,0,578759,2020-03-09,3.57584704722633,2.06451625529705
Wyoming,2020-03-16,0,0,2,0,578759,2020-03-10,2.54839640060692,1.47131734789228
Wyoming,2020-03-17,9,0,11,0,578759,2020-03-11,8.38341720818238,2.42008409093652
Wyoming,2020-03-18,5,0,16,0,578759,2020-03-12,6.08458172559667,1.47572783190224
Wyoming,2020-03-19,2,0,18,0,578759,2020-03-13,3.25268198958895,0.766664497293899
Wyoming,2020-03-20,3,0,21,0,578759,2020-03-14,2.52560643986493,0.551132508873761
Wyoming,2020-03-21,2,0,23,0,578759,2020-03-15,2.01584978573185,0.429780618383334
Wyoming,2020-03-22,3,0,26,0,578759,2020-03-16,1.87243681845827,0.374487363691654
Wyoming,2020-03-23,0,0,26,0,578759,2020-03-17,1.59310695161867,0.318621390323733
Wyoming,2020-03-24,3,0,29,0,578759,2020-03-18,1.06700291268422,0.244787256255478
Wyoming,2020-03-25,15,0,44,0,578759,2020-03-19,1.55790875340763,0.289296392813019
Wyoming,2020-03-26,9,0,53,0,578759,2020-03-20,1.81695758089887,0.302826263483145
Wyoming,2020-03-27,17,0,70,0,578759,2020-03-21,2.19213542442323,0.310014764777783
Wyoming,2020-03-28,12,0,82,0,578759,2020-03-22,2.16522942946199,0.279529917367482
Wyoming,2020-03-29,4,0,86,0,578759,2020-03-23,1.77568311968143,0.227352926393522
Wyoming,2020-03-30,8,0,94,0,578759,2020-03-24,1.69707478873933,0.204303796192736
Wyoming,2020-03-31,15,0,109,0,578759,2020-03-25,1.73983486690384,0.193314985211537
Wyoming,2020-04-01,21,0,130,0,578759,2020-03-26,1.62625397902245,0.174352727573981
Wyoming,2020-04-02,20,0,150,0,578759,2020-03-27,1.60881342369382,0.162514697365407
Wyoming,2020-04-03,12,0,162,0,578759,2020-03-28,1.35508529481165,0.140515799295922
Wyoming,2020-04-04,25,0,187,0,578759,2020-03-29,1.41183271910247,0.137129316007765
Wyoming,2020-04-05,10,0,197,0,578759,2020-03-30,1.38226020426263,0.130611312416438
Wyoming,2020-04-06,13,0,210,0,578759,2020-03-31,1.33234115434154,0.123174983292034
Wyoming,2020-04-07,6,0,216,0,578759,2020-04-01,1.14555050244457,0.11023064849278
Wyoming,2020-04-08,5,0,221,0,578759,2020-04-02,0.933494199016095,0.0973234979667597
Wyoming,2020-04-09,9,0,230,0,578759,2020-04-03,0.821331657027741,0.0912590730030823
Wyoming,2020-04-10,9,0,239,0,578759,2020-04-04,0.8180874127576,0.0926301589388201
Wyoming,2020-04-11,22,0,261,0,578759,2020-04-05,0.822457592946679,0.0949692225369634
Wyoming,2020-04-12,9,0,270,0,578759,2020-04-06,0.847431036654115,0.0985118570092679
Wyoming,2020-04-13,5,1,275,1,578759,2020-04-07,0.786357689803872,0.0967939404810222
Wyoming,2020-04-14,7,0,282,1,578759,2020-04-08,0.835172562747771,0.102032567932527
Wyoming,2020-04-15,5,0,287,1,578759,2020-04-09,0.874450219098105,0.106831097384465
Wyoming,2020-04-16,9,1,296,2,578759,2020-04-10,0.905037636597453,0.110567945184655
Wyoming,2020-04-17,9,0,305,2,578759,2020-04-11,0.92946962329311,0.113552787423784
Wyoming,2020-04-18,4,0,309,2,578759,2020-04-12,0.6938369174426,0.0991195596346571
Wyoming,2020-04-19,4,0,313,2,578759,2020-04-13,0.654958784044131,0.0987387518100815
Wyoming,2020-04-20,4,0,317,2,578759,2020-04-14,0.695657396363137,0.10608675838668
Wyoming,2020-04-21,126,0,443,2,578759,2020-04-15,2.83929824941066,0.223076338441041
Wyoming,2020-04-22,4,4,447,6,578759,2020-04-16,2.33826389625615,0.184281010917266
Wyoming,2020-04-23,6,1,453,7,578759,2020-04-17,1.72349310959552,0.137113749756539
Wyoming,2020-04-24,20,0,473,7,578759,2020-04-18,1.56027887822018,0.120021452170783
Wyoming,2020-04-25,18,0,491,7,578759,2020-04-19,1.50129043937788,0.110978582666886
Wyoming,2020-04-26,11,0,502,7,578759,2020-04-20,1.40506217792324,0.101933924001116
Wyoming,2020-04-27,18,0,520,7,578759,2020-04-21,1.38014274539273,0.0966293199744594
Wyoming,2020-04-28,16,0,536,7,578759,2020-04-22,0.587796317015708,0.0606265609842671
Wyoming,2020-04-29,9,0,545,7,578759,2020-04-23,0.633167176507221,0.0636356955770661
Wyoming,2020-04-30,14,0,559,7,578759,2020-04-24,0.75719104326362,0.0732004210701495
Wyoming,2020-05-01,7,0,566,7,578759,2020-04-25,0.714074780485518,0.0736511900010348
Wyoming,2020-05-02,13,0,579,7,578759,2020-04-26,0.719921909654869,0.0763115698004292
Wyoming,2020-05-03,7,0,586,7,578759,2020-04-27,0.736488791899935,0.079883425402581
Wyoming,2020-05-04,10,0,596,7,578759,2020-04-28,0.712113169429544,0.0811528272926906
Wyoming,2020-05-05,8,0,604,7,578759,2020-04-29,0.682218301843038,0.0821294322580989
Wyoming,2020-05-06,27,0,631,7,578759,2020-04-30,0.926508048286924,0.0993320892196512
Wyoming,2020-05-07,4,0,635,7,578759,2020-05-01,0.856919378719355,0.0976550263782926
Wyoming,2020-05-08,9,0,644,7,578759,2020-05-02,0.901350416998694,0.101409844865986
Wyoming,2020-05-09,9,0,653,7,578759,2020-05-03,0.881710315754102,0.10181113762958
Wyoming,2020-05-10,9,0,662,7,578759,2020-05-04,0.92954845386113,0.10593187764918
