stateName,date,positiveIncrease,deathIncrease,positive,death,population,interval_start,mean_rt,std_rt
Alabama,2020-03-08,0,0,0,0,4903185,2020-03-02,5,5
Alabama,2020-03-09,0,0,0,0,4903185,2020-03-03,5,5
Alabama,2020-03-10,0,0,0,0,4903185,2020-03-04,5,5
Alabama,2020-03-11,0,0,0,0,4903185,2020-03-05,5,5
Alabama,2020-03-12,0,0,0,0,4903185,2020-03-06,5,5
Alabama,2020-03-13,5,0,5,0,4903185,2020-03-07,30,12.2474487139159
Alabama,2020-03-14,2,0,7,0,4903185,2020-03-08,7.1522209622313,2.52869197146916
Alabama,2020-03-15,4,0,11,0,4903185,2020-03-09,4.84612973113375,1.39895715239896
Alabama,2020-03-16,18,0,29,0,4903185,2020-03-10,7.06239947215902,1.28941183367136
Alabama,2020-03-17,10,0,39,0,4903185,2020-03-11,4.40615588096876,0.696674415480351
Alabama,2020-03-18,12,0,51,0,4903185,2020-03-12,3.34395776931863,0.46372350770248
Alabama,2020-03-19,27,0,78,0,4903185,2020-03-13,3.45583033430692,0.388811289678186
Alabama,2020-03-20,28,0,106,0,4903185,2020-03-14,3.01488884696837,0.298518478417351
Alabama,2020-03-21,25,0,131,0,4903185,2020-03-15,2.61886179238633,0.234238119658111
Alabama,2020-03-22,26,0,157,0,4903185,2020-03-16,2.32194676824871,0.191510941670339
Alabama,2020-03-23,39,0,196,0,4903185,2020-03-17,2.09842253549497,0.16189681343141
Alabama,2020-03-24,46,0,242,0,4903185,2020-03-18,2.09202089841962,0.146470759971369
Alabama,2020-03-25,139,1,381,1,4903185,2020-03-19,2.79868851644623,0.153829833124717
Alabama,2020-03-26,136,0,517,1,4903185,2020-03-20,2.76380887280142,0.131759418202059
Alabama,2020-03-27,70,3,587,4,4903185,2020-03-21,2.21934805632989,0.101088533925228
Alabama,2020-03-28,107,0,694,4,4903185,2020-03-22,2.06806484608768,0.0870812391511439
Alabama,2020-03-29,131,6,825,10,4903185,2020-03-23,2.0268630876771,0.0783630542750749
Alabama,2020-03-30,74,0,899,10,4903185,2020-03-24,1.77299500853222,0.0668222636190267
Alabama,2020-03-31,88,13,987,23,4903185,2020-03-25,1.62388603200175,0.0594546918413023
Alabama,2020-04-01,73,4,1060,27,4903185,2020-03-26,1.32067173402003,0.0506454490876856
Alabama,2020-04-02,173,5,1233,32,4903185,2020-03-27,1.3098548792633,0.0489174268635239
Alabama,2020-04-03,262,6,1495,38,4903185,2020-03-28,1.58039769434376,0.0524184827064719
Alabama,2020-04-04,119,6,1614,44,4903185,2020-03-29,1.44736641685402,0.0476923449430177
Alabama,2020-04-05,151,1,1765,45,4903185,2020-03-30,1.35048639289546,0.0440245982033547
Alabama,2020-04-06,187,4,1952,49,4903185,2020-03-31,1.41706556693757,0.0436485317888767
Alabama,2020-04-07,217,15,2169,64,4903185,2020-04-01,1.475716620185,0.042905265743014
Alabama,2020-04-08,159,2,2328,66,4903185,2020-04-02,1.44779241687046,0.0406420388390998
Alabama,2020-04-09,375,4,2703,70,4903185,2020-04-03,1.5397903113725,0.040147198591214
Alabama,2020-04-10,244,10,2947,80,4903185,2020-04-04,1.37681301504338,0.0361195354141775
Alabama,2020-04-11,270,12,3217,92,4903185,2020-04-05,1.40850799169155,0.0351687662757518
Alabama,2020-04-12,346,1,3563,93,4903185,2020-04-06,1.46794203294077,0.0346093405706949
Alabama,2020-04-13,171,6,3734,99,4903185,2020-04-07,1.33309781066199,0.0315708550006064
Alabama,2020-04-14,219,15,3953,114,4903185,2020-04-08,1.24876875157686,0.0295571742860006
Alabama,2020-04-15,122,4,4075,118,4903185,2020-04-09,1.16865378499714,0.0279521459857844
Alabama,2020-04-16,270,15,4345,133,4903185,2020-04-10,1.06606823574782,0.0263006342451737
Alabama,2020-04-17,226,15,4571,148,4903185,2020-04-11,1.04415726014298,0.025902353726246
Alabama,2020-04-18,141,5,4712,153,4903185,2020-04-12,0.958255787545485,0.0247751135803126
Alabama,2020-04-19,176,4,4888,157,4903185,2020-04-13,0.858569158002333,0.0235778131365546
Alabama,2020-04-20,191,6,5079,163,4903185,2020-04-14,0.900224816207174,0.0245373948131495
Alabama,2020-04-21,238,20,5317,183,4903185,2020-04-15,0.937741241337289,0.025381465299232
Alabama,2020-04-22,276,13,5593,196,4903185,2020-04-16,1.05838892632033,0.0271560375390797
Alabama,2020-04-23,239,6,5832,202,4903185,2020-04-17,1.02654190069941,0.026611859091051
Alabama,2020-04-24,194,7,6026,209,4903185,2020-04-18,0.995039308956916,0.0260771154880448
Alabama,2020-04-25,0,0,6026,209,4903185,2020-04-19,0.89928802347892,0.0247991007621317
Alabama,2020-04-26,395,10,6421,219,4903185,2020-04-20,1.06989529478623,0.0273167229347557
Alabama,2020-04-27,118,9,6539,228,4903185,2020-04-21,1.01117990642811,0.0264547293653379
Alabama,2020-04-28,211,14,6750,242,4903185,2020-04-22,0.984936770346873,0.0260096061213295
Alabama,2020-04-29,162,14,6912,256,4903185,2020-04-23,0.90996663865589,0.0250460074158492
Alabama,2020-04-30,176,16,7088,272,4903185,2020-04-24,0.882118223259586,0.024880502950178
Alabama,2020-05-01,206,17,7294,289,4903185,2020-04-25,0.914256531589809,0.0256647631475323
Alabama,2020-05-02,317,-1,7611,288,4903185,2020-04-26,1.16522055519692,0.0292588023880634
Alabama,2020-05-03,277,2,7888,290,4903185,2020-04-27,1.04760377460971,0.0273422359524185
Alabama,2020-05-04,224,8,8112,298,4903185,2020-04-28,1.10195046443354,0.0277753607463593
Alabama,2020-05-05,325,17,8437,315,4903185,2020-04-29,1.16090687875003,0.0282560313270658
Alabama,2020-05-06,254,28,8691,343,4903185,2020-04-30,1.18499081908538,0.0280869760824976
Alabama,2020-05-07,355,26,9046,369,4903185,2020-05-01,1.25567048165453,0.028369943244264
Alabama,2020-05-08,339,14,9385,383,4903185,2020-05-02,1.27572985039599,0.027891885741994
Alabama,2020-05-09,283,7,9668,390,4903185,2020-05-03,1.18732900682984,0.0261726918944298
Alabama,2020-05-10,221,3,9889,393,4903185,2020-05-04,1.11088247239748,0.0248276764965985
Alaska,2020-03-08,0,0,0,0,731545,2020-03-02,5,5
Alaska,2020-03-09,0,0,0,0,731545,2020-03-03,5,5
Alaska,2020-03-10,0,0,0,0,731545,2020-03-04,5,5
Alaska,2020-03-11,0,0,0,0,731545,2020-03-05,5,5
Alaska,2020-03-12,0,0,0,0,731545,2020-03-06,5,5
Alaska,2020-03-13,1,0,1,0,731545,2020-03-07,10,7.07106781186548
Alaska,2020-03-14,0,0,1,0,731545,2020-03-08,5.21231403354432,3.68566259879299
Alaska,2020-03-15,0,0,1,0,731545,2020-03-09,3.43785639752253,2.43093157143374
Alaska,2020-03-16,0,0,1,0,731545,2020-03-10,2.81729392244855,1.99212763715902
Alaska,2020-03-17,2,0,3,0,731545,2020-03-11,4.96937221465047,2.48468610732523
Alaska,2020-03-18,2,0,5,0,731545,2020-03-12,4.81592845804913,1.96609455999482
Alaska,2020-03-19,3,0,8,0,731545,2020-03-13,4.35301664187717,1.45100554729239
Alaska,2020-03-20,3,0,11,0,731545,2020-03-14,3.31558372300468,0.999686106383288
Alaska,2020-03-21,2,0,13,0,731545,2020-03-15,2.72919242526151,0.756941786914486
Alaska,2020-03-22,5,0,18,0,731545,2020-03-16,2.86664862002319,0.675675559499152
Alaska,2020-03-23,12,0,30,0,731545,2020-03-17,3.56140239709558,0.65022014308074
Alaska,2020-03-24,4,0,34,0,731545,2020-03-18,2.55681790207889,0.451985819204786
Alaska,2020-03-25,7,1,41,1,731545,2020-03-19,2.22922958578075,0.366483086373497
Alaska,2020-03-26,15,0,56,1,731545,2020-03-20,2.39263796547132,0.34180542363876
Alaska,2020-03-27,2,0,58,1,731545,2020-03-21,1.85436900860922,0.267655111574358
Alaska,2020-03-28,27,1,85,2,731545,2020-03-22,2.39784524326016,0.280646558069954
Alaska,2020-03-29,17,0,102,2,731545,2020-03-23,2.22363632030926,0.24118722249344
Alaska,2020-03-30,12,1,114,3,731545,2020-03-24,1.77568192954951,0.192599746958745
Alaska,2020-03-31,5,0,119,3,731545,2020-03-25,1.55158132529192,0.167311317156894
Alaska,2020-04-01,13,0,132,3,731545,2020-03-26,1.50528747923764,0.156937068360344
Alaska,2020-04-02,11,0,143,3,731545,2020-03-27,1.31951644132068,0.140660925266288
Alaska,2020-04-03,14,0,157,3,731545,2020-03-28,1.41508881730013,0.141508881730013
Alaska,2020-04-04,14,2,171,5,731545,2020-03-29,1.1496435866588,0.123254729985278
Alaska,2020-04-05,14,1,185,6,731545,2020-03-30,1.07672377680986,0.117480195471188
Alaska,2020-04-06,5,0,190,6,731545,2020-03-31,0.982653022022703,0.111983704849513
Alaska,2020-04-07,23,0,213,6,731545,2020-04-01,1.22510260826948,0.125692875516754
Alaska,2020-04-08,13,1,226,7,731545,2020-04-02,1.18690957488345,0.121774352971301
Alaska,2020-04-09,9,0,235,7,731545,2020-04-03,1.11711561678215,0.115839493203208
Alaska,2020-04-10,11,0,246,7,731545,2020-04-04,1.05873919890646,0.111600910554882
Alaska,2020-04-11,11,1,257,8,731545,2020-04-05,1.01546702480313,0.108869492600587
Alaska,2020-04-12,15,0,272,8,731545,2020-04-06,1.02864105310272,0.109653504697144
Alaska,2020-04-13,5,0,277,8,731545,2020-04-07,1.02812998979085,0.109599025165048
Alaska,2020-04-14,8,1,285,9,731545,2020-04-08,0.850718832839972,0.0995691081369435
Alaska,2020-04-15,8,0,293,9,731545,2020-04-09,0.816861674886791,0.0990590284434469
Alaska,2020-04-16,7,0,300,9,731545,2020-04-10,0.829906124923342,0.102154382289695
Alaska,2020-04-17,9,0,309,9,731545,2020-04-11,0.837725523067022,0.104715690383378
Alaska,2020-04-18,5,0,314,9,731545,2020-04-12,0.786997009187653,0.103337769947701
Alaska,2020-04-19,5,0,319,9,731545,2020-04-13,0.681069887141297,0.098303970669494
Alaska,2020-04-20,2,0,321,9,731545,2020-04-14,0.683249255409324,0.101852785378091
Alaska,2020-04-21,8,0,329,9,731545,2020-04-15,0.733903455390117,0.109403867678286
Alaska,2020-04-22,6,0,335,9,731545,2020-04-16,0.742948913859788,0.113298647193779
Alaska,2020-04-23,2,0,337,9,731545,2020-04-17,0.691738589945823,0.112214817112001
Alaska,2020-04-24,2,0,339,9,731545,2020-04-18,0.600771446399692,0.107901737079679
Alaska,2020-04-25,0,0,339,9,731545,2020-04-19,0.547885633599452,0.10744921295926
Alaska,2020-04-26,1,0,340,9,731545,2020-04-20,0.51142777590259,0.109036768186589
Alaska,2020-04-27,5,0,345,9,731545,2020-04-21,0.645791086741571,0.129158217348314
Alaska,2020-04-28,6,0,351,9,731545,2020-04-22,0.642218488561512,0.133911811839024
Alaska,2020-04-29,4,0,355,9,731545,2020-04-23,0.62798626082824,0.137037836935128
Alaska,2020-04-30,0,0,355,9,731545,2020-04-24,0.612721103433781,0.140567861602241
Alaska,2020-05-01,9,0,364,9,731545,2020-04-25,0.908256024853976,0.178123661310332
Alaska,2020-05-02,1,0,365,9,731545,2020-04-26,0.965915406204689,0.185890506595561
Alaska,2020-05-03,3,0,368,9,731545,2020-04-27,1.0353130246398,0.192252802229595
Alaska,2020-05-04,2,0,370,9,731545,2020-04-28,0.919959441898404,0.180418890228996
Alaska,2020-05-05,1,0,371,9,731545,2020-04-29,0.752230178903067,0.16415008261207
Alaska,2020-05-06,1,1,372,10,731545,2020-04-30,0.680130960234189,0.160308404692171
Alaska,2020-05-07,2,0,374,10,731545,2020-05-01,0.814720051959323,0.182176941881321
Alaska,2020-05-08,3,0,377,10,731545,2020-05-02,0.598785004582043,0.160032023963134
Alaska,2020-05-09,1,0,378,10,731545,2020-05-03,0.649087867714199,0.173476029635584
Alaska,2020-05-10,1,0,379,10,731545,2020-05-04,0.606675542124503,0.175132143778172
American Samoa,2020-03-08,0,0,0,0,55641,2020-03-02,5,5
American Samoa,2020-03-09,0,0,0,0,55641,2020-03-03,5,5
American Samoa,2020-03-10,0,0,0,0,55641,2020-03-04,5,5
American Samoa,2020-03-11,0,0,0,0,55641,2020-03-05,5,5
American Samoa,2020-03-12,0,0,0,0,55641,2020-03-06,5,5
American Samoa,2020-03-13,0,0,0,0,55641,2020-03-07,5,5
American Samoa,2020-03-14,0,0,0,0,55641,2020-03-08,5,5
American Samoa,2020-03-15,0,0,0,0,55641,2020-03-09,5,5
American Samoa,2020-03-16,0,0,0,0,55641,2020-03-10,5,5
American Samoa,2020-03-17,0,0,0,0,55641,2020-03-11,5,5
American Samoa,2020-03-18,0,0,0,0,55641,2020-03-12,5,5
American Samoa,2020-03-19,0,0,0,0,55641,2020-03-13,5,5
American Samoa,2020-03-20,0,0,0,0,55641,2020-03-14,5,5
American Samoa,2020-03-21,0,0,0,0,55641,2020-03-15,5,5
American Samoa,2020-03-22,0,0,0,0,55641,2020-03-16,5,5
American Samoa,2020-03-23,0,0,0,0,55641,2020-03-17,5,5
American Samoa,2020-03-24,0,0,0,0,55641,2020-03-18,5,5
American Samoa,2020-03-25,0,0,0,0,55641,2020-03-19,5,5
American Samoa,2020-03-26,0,0,0,0,55641,2020-03-20,5,5
American Samoa,2020-03-27,0,0,0,0,55641,2020-03-21,5,5
American Samoa,2020-03-28,0,0,0,0,55641,2020-03-22,5,5
American Samoa,2020-03-29,0,0,0,0,55641,2020-03-23,5,5
American Samoa,2020-03-30,0,0,0,0,55641,2020-03-24,5,5
American Samoa,2020-03-31,0,0,0,0,55641,2020-03-25,5,5
American Samoa,2020-04-01,0,0,0,0,55641,2020-03-26,5,5
American Samoa,2020-04-02,0,0,0,0,55641,2020-03-27,5,5
American Samoa,2020-04-03,0,0,0,0,55641,2020-03-28,5,5
American Samoa,2020-04-04,0,0,0,0,55641,2020-03-29,5,5
American Samoa,2020-04-05,0,0,0,0,55641,2020-03-30,5,5
American Samoa,2020-04-06,0,0,0,0,55641,2020-03-31,5,5
American Samoa,2020-04-07,0,0,0,0,55641,2020-04-01,5,5
American Samoa,2020-04-08,0,0,0,0,55641,2020-04-02,5,5
American Samoa,2020-04-09,0,0,0,0,55641,2020-04-03,5,5
American Samoa,2020-04-10,0,0,0,0,55641,2020-04-04,5,5
American Samoa,2020-04-11,0,0,0,0,55641,2020-04-05,5,5
American Samoa,2020-04-12,0,0,0,0,55641,2020-04-06,5,5
American Samoa,2020-04-13,0,0,0,0,55641,2020-04-07,5,5
American Samoa,2020-04-14,0,0,0,0,55641,2020-04-08,5,5
American Samoa,2020-04-15,0,0,0,0,55641,2020-04-09,5,5
American Samoa,2020-04-16,0,0,0,0,55641,2020-04-10,5,5
American Samoa,2020-04-17,0,0,0,0,55641,2020-04-11,5,5
American Samoa,2020-04-18,0,0,0,0,55641,2020-04-12,5,5
American Samoa,2020-04-19,0,0,0,0,55641,2020-04-13,5,5
American Samoa,2020-04-20,0,0,0,0,55641,2020-04-14,5,5
American Samoa,2020-04-21,0,0,0,0,55641,2020-04-15,5,5
American Samoa,2020-04-22,0,0,0,0,55641,2020-04-16,5,5
American Samoa,2020-04-23,0,0,0,0,55641,2020-04-17,5,5
American Samoa,2020-04-24,0,0,0,0,55641,2020-04-18,5,5
American Samoa,2020-04-25,0,0,0,0,55641,2020-04-19,5,5
American Samoa,2020-04-26,0,0,0,0,55641,2020-04-20,5,5
American Samoa,2020-04-27,0,0,0,0,55641,2020-04-21,5,5
American Samoa,2020-04-28,0,0,0,0,55641,2020-04-22,5,5
American Samoa,2020-04-29,0,0,0,0,55641,2020-04-23,5,5
American Samoa,2020-04-30,0,0,0,0,55641,2020-04-24,5,5
American Samoa,2020-05-01,0,0,0,0,55641,2020-04-25,5,5
American Samoa,2020-05-02,0,0,0,0,55641,2020-04-26,5,5
American Samoa,2020-05-03,0,0,0,0,55641,2020-04-27,5,5
American Samoa,2020-05-04,0,0,0,0,55641,2020-04-28,5,5
American Samoa,2020-05-05,0,0,0,0,55641,2020-04-29,5,5
American Samoa,2020-05-06,0,0,0,0,55641,2020-04-30,5,5
American Samoa,2020-05-07,0,0,0,0,55641,2020-05-01,5,5
American Samoa,2020-05-08,0,0,0,0,55641,2020-05-02,5,5
American Samoa,2020-05-09,0,0,0,0,55641,2020-05-03,5,5
American Samoa,2020-05-10,0,0,0,0,55641,2020-05-04,5,5
Arizona,2020-03-08,0,0,4,0,7278717,2020-03-02,4.21420227245942,2.10710113622971
Arizona,2020-03-09,0,0,4,0,7278717,2020-03-03,2.71477830847369,1.35738915423685
Arizona,2020-03-10,2,0,6,0,7278717,2020-03-04,3.28815263664449,1.34238269269436
Arizona,2020-03-11,3,0,9,0,7278717,2020-03-05,3.66490251994728,1.22163417331576
Arizona,2020-03-12,0,0,9,0,7278717,2020-03-06,2.49435798033764,0.831452660112547
Arizona,2020-03-13,0,0,9,0,7278717,2020-03-07,1.73103637612694,0.612013780019972
Arizona,2020-03-14,3,0,12,0,7278717,2020-03-08,1.74985705046977,0.583285683489924
Arizona,2020-03-15,0,0,12,0,7278717,2020-03-09,1.58806257930041,0.529354193100138
Arizona,2020-03-16,6,0,18,0,7278717,2020-03-10,2.43477414828592,0.628655981872513
Arizona,2020-03-17,2,0,20,0,7278717,2020-03-11,1.96467000159629,0.507275613131716
Arizona,2020-03-18,7,0,27,0,7278717,2020-03-12,2.08366680019999,0.478025948109607
Arizona,2020-03-19,18,0,45,0,7278717,2020-03-13,3.40680650180611,0.560075538842232
Arizona,2020-03-20,23,0,68,0,7278717,2020-03-14,3.81586062141911,0.492625487940163
Arizona,2020-03-21,36,1,104,1,7278717,2020-03-15,3.77637886130232,0.39159224601716
Arizona,2020-03-22,48,1,152,2,7278717,2020-03-16,3.67084867738024,0.309141226560026
Arizona,2020-03-23,83,0,235,2,7278717,2020-03-17,3.68840912582377,0.249810587690542
Arizona,2020-03-24,91,3,326,5,7278717,2020-03-18,3.37206191523751,0.192453738763771
Arizona,2020-03-25,75,1,401,6,7278717,2020-03-19,2.77547851132768,0.143325094028382
Arizona,2020-03-26,107,2,508,8,7278717,2020-03-20,2.5131944475163,0.116672123209057
Arizona,2020-03-27,157,5,665,13,7278717,2020-03-21,2.48479977021632,0.101611018893855
Arizona,2020-03-28,108,2,773,15,7278717,2020-03-22,2.14925182080257,0.0830328418141643
Arizona,2020-03-29,146,2,919,17,7278717,2020-03-23,1.99357736982497,0.0719370269449244
Arizona,2020-03-30,238,3,1157,20,7278717,2020-03-24,2.00286229898696,0.0659250155864115
Arizona,2020-03-31,132,5,1289,25,7278717,2020-03-25,1.74806122039056,0.0563012609234451
Arizona,2020-04-01,124,7,1413,32,7278717,2020-03-26,1.59357362960582,0.0500688263999979
Arizona,2020-04-02,183,3,1596,35,7278717,2020-03-27,1.53673941809978,0.0465678611545388
Arizona,2020-04-03,173,9,1769,44,7278717,2020-03-28,1.41479738094281,0.0425611259028709
Arizona,2020-04-04,250,8,2019,52,7278717,2020-03-29,1.47781037907732,0.0418490386280107
Arizona,2020-04-05,250,12,2269,64,7278717,2020-03-30,1.47102369226767,0.0400213738528851
Arizona,2020-04-06,191,1,2460,65,7278717,2020-03-31,1.29930384978048,0.0359808923180748
Arizona,2020-04-07,115,8,2575,73,7278717,2020-04-01,1.20931993133932,0.033709471004161
Arizona,2020-04-08,151,16,2726,89,7278717,2020-04-02,1.19093491471091,0.0328541582785635
Arizona,2020-04-09,292,9,3018,98,7278717,2020-04-03,1.24888110703047,0.0331069098045697
Arizona,2020-04-10,94,8,3112,106,7278717,2020-04-04,1.12881070666745,0.0307908363605962
Arizona,2020-04-11,281,11,3393,117,7278717,2020-04-05,1.12480055859871,0.0303336152762331
Arizona,2020-04-12,149,8,3542,125,7278717,2020-04-06,1.02201756589267,0.0286334478666006
Arizona,2020-04-13,163,7,3705,132,7278717,2020-04-07,0.99612643232146,0.0282198982250867
Arizona,2020-04-14,104,11,3809,143,7278717,2020-04-08,0.992969587811203,0.0282554656289588
Arizona,2020-04-15,155,12,3964,155,7278717,2020-04-09,1.00086749693225,0.0284341946833829
Arizona,2020-04-16,273,9,4237,164,7278717,2020-04-10,0.987566626797282,0.0282739502764045
Arizona,2020-04-17,274,19,4511,183,7278717,2020-04-11,1.13717577029974,0.0303923008643026
Arizona,2020-04-18,213,-3,4724,180,7278717,2020-04-12,1.05697283203489,0.0289608771993019
Arizona,2020-04-19,209,4,4933,184,7278717,2020-04-13,1.08664930841654,0.0291252586131548
Arizona,2020-04-20,135,7,5068,191,7278717,2020-04-14,1.04919252331988,0.0284084802994716
Arizona,2020-04-21,188,17,5256,208,7278717,2020-04-15,1.1019095213114,0.028957539323495
Arizona,2020-04-22,217,23,5473,231,7278717,2020-04-16,1.12884591579293,0.0290500037227704
Arizona,2020-04-23,299,18,5772,249,7278717,2020-04-17,1.11896749848408,0.0285510355212968
Arizona,2020-04-24,273,17,6045,266,7278717,2020-04-18,1.09152300252793,0.0278598454231478
Arizona,2020-04-25,241,7,6286,273,7278717,2020-04-19,1.09152963317928,0.0276093410540915
Arizona,2020-04-26,248,2,6534,275,7278717,2020-04-20,1.1001269045265,0.0274859992286513
Arizona,2020-04-27,191,0,6725,275,7278717,2020-04-21,1.11730581671557,0.02743972765608
Arizona,2020-04-28,230,0,6955,275,7278717,2020-04-22,1.12022999169388,0.0271695681219921
Arizona,2020-04-29,254,33,7209,308,7278717,2020-04-23,1.11795093397039,0.0268239563612032
Arizona,2020-04-30,446,12,7655,320,7278717,2020-04-24,1.18511435422356,0.0273035934790998
Arizona,2020-05-01,314,10,7969,330,7278717,2020-04-25,1.16967835868327,0.0266594440055816
Arizona,2020-05-02,395,0,8364,330,7278717,2020-04-26,1.21994812426372,0.0267555645374102
Arizona,2020-05-03,276,32,8640,362,7278717,2020-04-27,1.18599078352389,0.0258374141307199
Arizona,2020-05-04,284,0,8924,362,7278717,2020-04-28,1.19227815036064,0.025419455575203
Arizona,2020-05-05,381,33,9305,395,7278717,2020-04-29,1.22867676666457,0.0253402754639237
Arizona,2020-05-06,402,31,9707,426,7278717,2020-04-30,1.25043490246827,0.0250137012899975
Arizona,2020-05-07,238,24,9945,450,7278717,2020-05-01,1.09187464437478,0.02281183576938
Arizona,2020-05-08,581,67,10526,517,7278717,2020-05-02,1.19412209267425,0.0236101346182076
Arizona,2020-05-09,434,15,10960,532,7278717,2020-05-03,1.17503522864998,0.0230576430952769
Arizona,2020-05-10,159,4,11119,536,7278717,2020-05-04,1.0827701049832,0.0217425469270073
Arkansas,2020-03-08,0,0,0,0,3017804,2020-03-02,5,5
Arkansas,2020-03-09,0,0,0,0,3017804,2020-03-03,5,5
Arkansas,2020-03-10,0,0,0,0,3017804,2020-03-04,5,5
Arkansas,2020-03-11,0,0,0,0,3017804,2020-03-05,5,5
Arkansas,2020-03-12,0,0,0,0,3017804,2020-03-06,5,5
Arkansas,2020-03-13,9,0,9,0,3017804,2020-03-07,50,15.8113883008419
Arkansas,2020-03-14,3,0,12,0,3017804,2020-03-08,7.01428523408422,1.94541269786312
Arkansas,2020-03-15,-9,0,3,0,3017804,2020-03-09,3.10489209522714,0.861142127240328
Arkansas,2020-03-16,0,0,3,0,3017804,2020-03-10,2.19062357345288,0.607569663024964
Arkansas,2020-03-17,0,0,3,0,3017804,2020-03-11,1.81207927260099,0.502580364043719
Arkansas,2020-03-18,1,0,4,0,3017804,2020-03-12,1.72395494852921,0.460746340544987
Arkansas,2020-03-19,58,0,62,0,3017804,2020-03-13,7.95713221033455,0.93775702412091
Arkansas,2020-03-20,38,0,100,0,3017804,2020-03-14,4.9278848334859,0.490342867839023
Arkansas,2020-03-21,22,0,122,0,3017804,2020-03-15,3.16474837216252,0.288900678710195
Arkansas,2020-03-22,43,0,165,0,3017804,2020-03-16,2.95992894790284,0.231839527966676
Arkansas,2020-03-23,27,0,192,0,3017804,2020-03-17,2.48848948212513,0.180534001793034
Arkansas,2020-03-24,27,2,219,2,3017804,2020-03-18,2.17865482977571,0.147896726754907
Arkansas,2020-03-25,61,0,280,2,3017804,2020-03-19,2.25215491688344,0.135318874235416
Arkansas,2020-03-26,55,0,335,2,3017804,2020-03-20,1.79186838503989,0.108250727974246
Arkansas,2020-03-27,46,1,381,3,3017804,2020-03-21,1.58199134503997,0.0942062136711808
Arkansas,2020-03-28,28,2,409,5,3017804,2020-03-22,1.4561386959396,0.0858037955205853
Arkansas,2020-03-29,17,1,426,6,3017804,2020-03-23,1.22121996227519,0.0754472212333218
Arkansas,2020-03-30,47,1,473,7,3017804,2020-03-24,1.26359748134104,0.0752461350024471
Arkansas,2020-03-31,50,1,523,8,3017804,2020-03-25,1.31324075792499,0.075195947054093
Arkansas,2020-04-01,61,2,584,10,3017804,2020-03-26,1.24186802806828,0.0711091564309547
Arkansas,2020-04-02,59,2,643,12,3017804,2020-03-27,1.20163299931824,0.0683585129640923
Arkansas,2020-04-03,61,0,704,12,3017804,2020-03-28,1.21588951029461,0.0675494172385894
Arkansas,2020-04-04,39,2,743,14,3017804,2020-03-29,1.21022070904301,0.0661214207528682
Arkansas,2020-04-05,94,2,837,16,3017804,2020-03-30,1.4316101521579,0.0705303698919209
Arkansas,2020-04-06,38,0,875,16,3017804,2020-03-31,1.29634239970768,0.06457541453204
Arkansas,2020-04-07,71,2,946,18,3017804,2020-04-01,1.27996640170009,0.0621606635131796
Arkansas,2020-04-08,54,0,1000,18,3017804,2020-04-02,1.1962263874902,0.0585794582252692
Arkansas,2020-04-09,119,3,1119,21,3017804,2020-04-03,1.31770424212866,0.0603335326054576
Arkansas,2020-04-10,52,0,1171,21,3017804,2020-04-04,1.22294574472584,0.0565306870476861
Arkansas,2020-04-11,57,4,1228,25,3017804,2020-04-05,1.212739250281,0.0550109695228493
Arkansas,2020-04-12,52,2,1280,27,3017804,2020-04-06,1.06651187559953,0.0506144137145142
Arkansas,2020-04-13,130,2,1410,29,3017804,2020-04-07,1.27047012451924,0.0548759513108296
Arkansas,2020-04-14,88,3,1498,32,3017804,2020-04-08,1.25514251761983,0.0533740890387647
Arkansas,2020-04-15,71,1,1569,33,3017804,2020-04-09,1.22689465991373,0.0513889623367075
Arkansas,2020-04-16,51,4,1620,37,3017804,2020-04-10,1.03427306628151,0.0461618660774422
Arkansas,2020-04-17,75,0,1695,37,3017804,2020-04-11,1.07282976017852,0.0468221293697083
Arkansas,2020-04-18,49,1,1744,38,3017804,2020-04-12,1.04960372961693,0.0461615192475018
Arkansas,2020-04-19,37,1,1781,39,3017804,2020-04-13,1.01054153017039,0.045102675784774
Arkansas,2020-04-20,192,2,1973,41,3017804,2020-04-14,1.13526736977744,0.0478033798191103
Arkansas,2020-04-21,17,1,1990,42,3017804,2020-04-15,0.970887903418011,0.0437265920225384
Arkansas,2020-04-22,286,0,2276,42,3017804,2020-04-16,1.39560847366076,0.0524501782937099
Arkansas,2020-04-23,323,3,2599,45,3017804,2020-04-17,1.8110021065775,0.0578503402528945
Arkansas,2020-04-24,211,2,2810,47,3017804,2020-04-18,1.76872838154225,0.0529454991950375
Arkansas,2020-04-25,101,1,2911,48,3017804,2020-04-19,1.58773208497212,0.0464574961663104
Arkansas,2020-04-26,90,3,3001,51,3017804,2020-04-20,1.4778086862847,0.042292210287354
Arkansas,2020-04-27,68,0,3069,51,3017804,2020-04-21,1.21284998029847,0.0366187716145407
Arkansas,2020-04-28,58,6,3127,57,3017804,2020-04-22,1.20595901925243,0.0357487959426605
Arkansas,2020-04-29,66,0,3193,57,3017804,2020-04-23,0.942785147009826,0.0311165465622227
Arkansas,2020-04-30,88,4,3281,61,3017804,2020-04-24,0.709450298824266,0.0271463612477335
Arkansas,2020-05-01,56,3,3337,64,3017804,2020-04-25,0.587128262374657,0.0255514779148806
Arkansas,2020-05-02,35,8,3372,72,3017804,2020-04-26,0.566833817690211,0.0263714958640314
Arkansas,2020-05-03,65,4,3437,76,3017804,2020-04-27,0.593142751436511,0.028373865710115
Arkansas,2020-05-04,54,4,3491,80,3017804,2020-04-28,0.628051415068425,0.0305369047730655
Arkansas,2020-05-05,34,3,3525,83,3017804,2020-04-29,0.64014879144164,0.0320475240456126
Arkansas,2020-05-06,86,4,3611,87,3017804,2020-04-30,0.722338394477474,0.0352885397954928
Arkansas,2020-05-07,92,0,3703,87,3017804,2020-05-01,0.770572943969503,0.0374665386402064
Arkansas,2020-05-08,44,1,3747,88,3017804,2020-05-02,0.780289311193803,0.0384888333148075
Arkansas,2020-05-09,0,0,3747,88,3017804,2020-05-03,0.742432694915871,0.0382880427726701
Arkansas,2020-05-10,265,3,4012,91,3017804,2020-05-04,1.19313658260368,0.0497140242751533
California,2020-03-08,14,0,95,1,39512223,2020-03-02,2.72315559666802,0.297120634544615
California,2020-03-09,6,0,101,1,39512223,2020-03-03,1.94204313388222,0.215782570431358
California,2020-03-10,43,1,144,2,39512223,2020-03-04,2.40994819283056,0.219997164605351
California,2020-03-11,34,2,178,4,39512223,2020-03-05,2.29807388337231,0.191506156947693
California,2020-03-12,43,0,221,4,39512223,2020-03-06,2.15648258186997,0.164910344699594
California,2020-03-13,60,0,281,4,39512223,2020-03-07,2.2847989607541,0.153001455063028
California,2020-03-14,91,-1,372,3,39512223,2020-03-08,2.38982020837601,0.139853649390412
California,2020-03-15,1,2,373,5,39512223,2020-03-09,1.78700267379748,0.106985051650017
California,2020-03-16,184,2,557,7,39512223,2020-03-10,2.50278011107635,0.117075115542163
California,2020-03-17,143,5,700,12,39512223,2020-03-11,2.38757734082375,0.101164898703305
California,2020-03-18,128,4,828,16,39512223,2020-03-12,2.16208936380175,0.0847389632040183
California,2020-03-19,177,2,1005,18,39512223,2020-03-13,2.1085864044093,0.0752586759910328
California,2020-03-20,238,6,1243,24,39512223,2020-03-14,2.11943231989137,0.0682977519900562
California,2020-03-21,162,1,1405,25,39512223,2020-03-15,1.86087986900373,0.0578706110865213
California,2020-03-22,241,5,1646,30,39512223,2020-03-16,1.94856757293717,0.0545922202085756
California,2020-03-23,462,9,2108,39,39512223,2020-03-17,2.00643554569584,0.0509306659227513
California,2020-03-24,430,11,2538,50,39512223,2020-03-18,1.97970157196681,0.0461645772954994
California,2020-03-25,460,15,2998,65,39512223,2020-03-19,1.95214077214894,0.041896835386749
California,2020-03-26,901,16,3899,81,39512223,2020-03-20,2.1863747667322,0.040635005458375
California,2020-03-27,758,13,4657,94,39512223,2020-03-21,2.09172764183796,0.0357939627307923
California,2020-03-28,438,16,5095,110,39512223,2020-03-22,1.84612719557504,0.0303871239532743
California,2020-03-29,757,14,5852,124,39512223,2020-03-23,1.7939458613396,0.0276581467454404
California,2020-03-30,1286,22,7138,146,39512223,2020-03-24,1.85713261498579,0.026182780113788
California,2020-03-31,1072,27,8210,173,39512223,2020-03-25,1.79282485208725,0.0238029876875977
California,2020-04-01,1189,26,9399,199,39512223,2020-03-26,1.74447821260578,0.0218025712719141
California,2020-04-02,1374,39,10773,238,39512223,2020-03-27,1.63216751527575,0.0196846808842776
California,2020-04-03,1231,27,12004,265,39512223,2020-03-28,1.54878048077132,0.018067800759395
California,2020-04-04,833,24,12837,289,39512223,2020-03-29,1.47390140759481,0.0167499611466043
California,2020-04-05,2197,59,15034,348,39512223,2020-03-30,1.60064145669063,0.0167032802870737
California,2020-04-06,985,32,16019,380,39512223,2020-03-31,1.3898818108981,0.0147476386206281
California,2020-04-07,1332,52,17351,432,39512223,2020-04-01,1.32178059075238,0.0138241603243425
California,2020-04-08,1546,63,18897,495,39512223,2020-04-02,1.29698602601637,0.0133074962694704
California,2020-04-09,813,49,19710,544,39512223,2020-04-03,1.15651006255224,0.0122328947928453
California,2020-04-10,1371,39,21081,583,39512223,2020-04-04,1.14038147979512,0.0119689228170958
California,2020-04-11,625,21,21706,604,39512223,2020-04-05,1.09060877394492,0.0115799631493166
California,2020-04-12,1089,36,22795,640,39512223,2020-04-06,0.940062065557689,0.0106701299506711
California,2020-04-13,1136,74,23931,714,39512223,2020-04-07,0.97164923326714,0.0109229244408506
California,2020-04-14,1425,53,25356,767,39512223,2020-04-08,0.996504131812928,0.0111370792710213
California,2020-04-15,1330,93,26686,860,39512223,2020-04-09,0.972642629081637,0.0110200755299758
California,2020-04-16,991,96,27677,956,39512223,2020-04-10,1.0008735926865,0.0112125545297886
California,2020-04-17,1480,81,29157,1037,39512223,2020-04-11,1.01654886898838,0.0113110577584241
California,2020-04-18,1334,103,30491,1140,39512223,2020-04-12,1.10233201942712,0.0117602572838934
California,2020-04-19,940,37,31431,1177,39512223,2020-04-13,1.06321381441507,0.0114403457788251
California,2020-04-20,2255,48,33686,1225,39512223,2020-04-14,1.18232247000879,0.0119701625391805
California,2020-04-21,1779,57,35465,1282,39512223,2020-04-15,1.18523257088365,0.0117876708338747
California,2020-04-22,1879,139,37344,1421,39512223,2020-04-16,1.20113096767949,0.0116340823359744
California,2020-04-23,2217,112,39561,1533,39512223,2020-04-17,1.28708688573054,0.0118061493336442
California,2020-04-24,1794,88,41355,1621,39512223,2020-04-18,1.2503793392517,0.0113208666109815
California,2020-04-25,1013,68,42368,1689,39512223,2020-04-19,1.1562762181626,0.0106093782385152
California,2020-04-26,1190,36,43558,1725,39512223,2020-04-20,1.14410512021157,0.0103889423202828
California,2020-04-27,1408,54,44966,1779,39512223,2020-04-21,1.0375704324925,0.009768857794358
California,2020-04-28,1198,85,46164,1864,39512223,2020-04-22,0.976962754297006,0.00944465543017469
California,2020-04-29,2583,82,48747,1946,39512223,2020-04-23,1.05002890341556,0.00983269684365532
California,2020-04-30,1383,85,50130,2031,39512223,2020-04-24,0.968571341359439,0.00942093746679924
California,2020-05-01,1896,95,52026,2126,39512223,2020-04-25,0.982400361303142,0.00950967347532224
California,2020-05-02,1321,54,53347,2180,39512223,2020-04-26,1.01792441224542,0.00971436371515253
California,2020-05-03,1556,36,54903,2216,39512223,2020-04-27,1.04945754069691,0.00985243283293251
California,2020-05-04,981,62,55884,2278,39512223,2020-04-28,1.00012653095058,0.00957113661462996
California,2020-05-05,2572,103,58456,2381,39512223,2020-04-29,1.12410739263715,0.0101386204043273
California,2020-05-06,2160,83,60616,2464,39512223,2020-04-30,1.06278684314999,0.00975485481263365
California,2020-05-07,1532,71,62148,2535,39512223,2020-05-01,1.05822114759738,0.00965255463945525
California,2020-05-08,1631,78,63779,2613,39512223,2020-05-02,1.02426317093458,0.00944753944923222
California,2020-05-09,2779,74,66558,2687,39512223,2020-05-03,1.1456411262799,0.00996699666761242
California,2020-05-10,1042,29,67600,2716,39512223,2020-05-04,1.07355242084697,0.00952698747440995
Colorado,2020-03-08,0,0,7,0,5758736,2020-03-02,3.84596795083389,1.35975500913039
Colorado,2020-03-09,0,0,7,0,5758736,2020-03-03,2.45644816866271,0.868485578847339
Colorado,2020-03-10,7,0,14,0,5758736,2020-03-04,3.69968769873724,0.955255256225186
Colorado,2020-03-11,16,0,30,0,5758736,2020-03-05,5.21795360212451,0.937172132671271
Colorado,2020-03-12,15,0,45,0,5758736,2020-03-06,4.28495740248201,0.631782501462354
Colorado,2020-03-13,31,1,76,1,5758736,2020-03-07,4.1273617290135,0.479796055239427
Colorado,2020-03-14,25,-1,101,0,5758736,2020-03-08,3.26922322000293,0.335415225185713
Colorado,2020-03-15,-2,1,99,1,5758736,2020-03-09,2.22677367859126,0.228462158922765
Colorado,2020-03-16,33,0,132,1,5758736,2020-03-10,2.38729863223221,0.211009381446096
Colorado,2020-03-17,35,1,167,2,5758736,2020-03-11,2.30927328834199,0.184889834146803
Colorado,2020-03-18,51,0,218,2,5758736,2020-03-12,2.23905262933957,0.162012162250334
Colorado,2020-03-19,59,2,277,4,5758736,2020-03-13,2.21053447037011,0.144199369147474
Colorado,2020-03-20,86,0,363,4,5758736,2020-03-14,2.19862421137113,0.12910765920317
Colorado,2020-03-21,112,2,475,6,5758736,2020-03-15,2.30705500992644,0.118819378100848
Colorado,2020-03-22,116,0,591,6,5758736,2020-03-16,2.39582797748343,0.107902665342506
Colorado,2020-03-23,113,1,704,7,5758736,2020-03-17,2.17564124867904,0.0908887170567742
Colorado,2020-03-24,19,1,723,8,5758736,2020-03-18,1.70360152640032,0.0721839133343518
Colorado,2020-03-25,298,8,1021,16,5758736,2020-03-19,2.14563290422422,0.0756706381118251
Colorado,2020-03-26,409,3,1430,19,5758736,2020-03-20,2.54168895592267,0.0748203089966416
Colorado,2020-03-27,3,8,1433,27,5758736,2020-03-21,1.80288563769408,0.0550900851462636
Colorado,2020-03-28,307,4,1740,31,5758736,2020-03-22,1.80548852589595,0.0507432033218879
Colorado,2020-03-29,567,16,2307,47,5758736,2020-03-23,2.12971202759578,0.0513967592469297
Colorado,2020-03-30,4,0,2311,47,5758736,2020-03-24,1.63654285124988,0.0408116693265489
Colorado,2020-03-31,655,22,2966,69,5758736,2020-03-25,2.00252203811864,0.0422732733584891
Colorado,2020-04-01,16,0,2982,69,5758736,2020-03-26,1.47806611175103,0.0333690896197723
Colorado,2020-04-02,360,11,3342,80,5758736,2020-03-27,1.29833178538661,0.0296843951724012
Colorado,2020-04-03,400,17,3742,97,5758736,2020-03-28,1.49261466141558,0.031055727925798
Colorado,2020-04-04,446,14,4188,111,5758736,2020-03-29,1.45629042409349,0.0294275157785091
Colorado,2020-04-05,762,29,4950,140,5758736,2020-03-30,1.43899089147952,0.0279851294108063
Colorado,2020-04-06,233,10,5183,150,5758736,2020-03-31,1.44064931573789,0.0268775986346658
Colorado,2020-04-07,246,29,5429,179,5758736,2020-04-01,1.13777450588203,0.0229211206180592
Colorado,2020-04-08,226,14,5655,193,5758736,2020-04-02,1.19787492065231,0.0231649181981356
Colorado,2020-04-09,0,0,5655,193,5758736,2020-04-03,1.00823904122935,0.0209595441514545
Colorado,2020-04-10,547,33,6202,226,5758736,2020-04-04,1.06964141867896,0.0215616704758061
Colorado,2020-04-11,311,24,6513,250,5758736,2020-04-05,1.00661021672778,0.0208716353621761
Colorado,2020-04-12,794,39,7307,289,5758736,2020-04-06,1.019702758102,0.0209991489273887
Colorado,2020-04-13,384,17,7691,306,5758736,2020-04-07,1.0853689561072,0.0216684110220869
Colorado,2020-04-14,259,21,7950,327,5758736,2020-04-08,1.07547065102374,0.0214153916908881
Colorado,2020-04-15,6,1,7956,328,5758736,2020-04-09,0.966238558829134,0.020138712633989
Colorado,2020-04-16,330,27,8286,355,5758736,2020-04-10,1.11117948129482,0.0216591431065595
Colorado,2020-04-17,405,17,8691,372,5758736,2020-04-11,1.03493749614184,0.0207402720306111
Colorado,2020-04-18,356,17,9047,389,5758736,2020-04-12,1.04189148615127,0.0206934788431753
Colorado,2020-04-19,683,31,9730,420,5758736,2020-04-13,0.990369558194539,0.0201155066143633
Colorado,2020-04-20,0,0,9730,420,5758736,2020-04-14,0.834808912349826,0.0184829799839636
Colorado,2020-04-21,743,63,10473,483,5758736,2020-04-15,1.06786493919331,0.0212555160022597
Colorado,2020-04-22,418,23,10891,506,5758736,2020-04-16,1.23767310974886,0.0228416740430968
Colorado,2020-04-23,387,46,11278,552,5758736,2020-04-17,1.20100552429599,0.0219528872375665
Colorado,2020-04-24,978,122,12256,674,5758736,2020-04-18,1.36725097917255,0.0228958923057811
Colorado,2020-04-25,712,10,12968,684,5758736,2020-04-19,1.40358189377136,0.0224121728127683
Colorado,2020-04-26,473,4,13441,688,5758736,2020-04-20,1.22418347835784,0.0200928957136219
Colorado,2020-04-27,438,18,13879,706,5758736,2020-04-21,1.30376215451773,0.0202383136324991
Colorado,2020-04-28,437,30,14316,736,5758736,2020-04-22,1.1447367052501,0.0184634952459694
Colorado,2020-04-29,442,30,14758,766,5758736,2020-04-23,1.11587165902085,0.0179420067107953
Colorado,2020-04-30,526,11,15284,777,5758736,2020-04-24,1.13541385086474,0.0179367814548263
Colorado,2020-05-01,509,44,15793,821,5758736,2020-04-25,0.979305682590824,0.0164641517488145
Colorado,2020-05-02,432,11,16225,832,5758736,2020-04-26,0.904526398213241,0.0158469506729414
Colorado,2020-05-03,410,10,16635,842,5758736,2020-04-27,0.909046997522092,0.0160824016972521
Colorado,2020-05-04,283,9,16918,851,5758736,2020-04-28,0.885485422141296,0.0160599660895537
Colorado,2020-05-05,449,52,17367,903,5758736,2020-04-29,0.911391842452151,0.0164973000142925
Colorado,2020-05-06,465,16,17832,919,5758736,2020-04-30,0.937127113055586,0.0168995812333155
Colorado,2020-05-07,538,25,18370,944,5758736,2020-05-01,0.953055030577545,0.0171533782086207
Colorado,2020-05-08,457,16,18827,960,5758736,2020-05-02,0.945376906377562,0.0171603302456289
Colorado,2020-05-09,548,7,19375,967,5758736,2020-05-03,0.99136617488958,0.0176607805966719
Colorado,2020-05-10,328,4,19703,971,5758736,2020-05-04,0.967768092829804,0.0174691934915302
Connecticut,2020-03-08,0,0,0,0,3565287,2020-03-02,5,5
Connecticut,2020-03-09,0,0,0,0,3565287,2020-03-03,5,5
Connecticut,2020-03-10,1,0,1,0,3565287,2020-03-04,10,7.07106781186548
Connecticut,2020-03-11,2,0,3,0,3565287,2020-03-05,10.4246280670886,5.21231403354432
Connecticut,2020-03-12,2,0,5,0,3565287,2020-03-06,6.32130340868913,2.58066131010073
Connecticut,2020-03-13,6,0,11,0,3565287,2020-03-07,6.51879758698713,1.88181477081985
Connecticut,2020-03-14,12,0,23,0,3565287,2020-03-08,6.50320331950031,1.32746081886246
Connecticut,2020-03-15,1,0,24,0,3565287,2020-03-09,3.2881135792857,0.65762271585714
Connecticut,2020-03-16,17,0,41,0,3565287,2020-03-10,3.70776594647947,0.572120706417148
Connecticut,2020-03-17,27,0,68,0,3565287,2020-03-11,3.98441232760226,0.483180967138742
Connecticut,2020-03-18,28,1,96,1,3565287,2020-03-12,3.46012284988483,0.356884422203674
Connecticut,2020-03-19,63,2,159,3,3565287,2020-03-13,3.79934886384022,0.305171044468021
Connecticut,2020-03-20,35,1,194,4,3565287,2020-03-14,2.90622561028887,0.214249794504225
Connecticut,2020-03-21,0,0,194,4,3565287,2020-03-15,1.93802872163525,0.14777330465645
Connecticut,2020-03-22,133,4,327,8,3565287,2020-03-16,2.86065391195205,0.164069754140044
Connecticut,2020-03-23,88,2,415,10,3565287,2020-03-17,2.63123385144661,0.135876331821732
Connecticut,2020-03-24,203,2,618,12,3565287,2020-03-18,2.88022303730239,0.122701626687118
Connecticut,2020-03-25,257,7,875,19,3565287,2020-03-19,2.97362314466859,0.106472788184254
Connecticut,2020-03-26,137,2,1012,21,3565287,2020-03-20,2.32638765773681,0.0796073468040955
Connecticut,2020-03-27,279,6,1291,27,3565287,2020-03-21,2.33563416133801,0.0704861270930431
Connecticut,2020-03-28,233,6,1524,33,3565287,2020-03-22,2.24566792303949,0.0615540322682537
Connecticut,2020-03-29,469,1,1993,34,3565287,2020-03-23,2.24754821910492,0.0550479585704363
Connecticut,2020-03-30,578,2,2571,36,3565287,2020-03-24,2.32927837620262,0.0501529314134999
Connecticut,2020-03-31,557,33,3128,69,3565287,2020-03-25,2.14310020684106,0.0427680177692592
Connecticut,2020-04-01,429,16,3557,85,3565287,2020-03-26,1.8555459507101,0.0358229525115954
Connecticut,2020-04-02,267,27,3824,112,3565287,2020-03-27,1.65733180790335,0.031248170776115
Connecticut,2020-04-03,1090,19,4914,131,3565287,2020-03-28,1.89131078780145,0.0314172961041554
Connecticut,2020-04-04,362,34,5276,165,3565287,2020-03-29,1.67690206155216,0.0273727490854701
Connecticut,2020-04-05,399,24,5675,189,3565287,2020-03-30,1.44151690364767,0.0237530224922821
Connecticut,2020-04-06,1231,17,6906,206,3565287,2020-03-31,1.56150749889685,0.0237137063391076
Connecticut,2020-04-07,875,71,7781,277,3565287,2020-04-01,1.5202793066632,0.0222848746029608
Connecticut,2020-04-08,0,49,7781,326,3565287,2020-04-02,1.24968484004955,0.0192259206161469
Connecticut,2020-04-09,2003,54,9784,380,3565287,2020-04-03,1.67676606525019,0.0217176542676817
Connecticut,2020-04-10,754,68,10538,448,3565287,2020-04-04,1.41392087339371,0.0188522783119161
Connecticut,2020-04-11,972,46,11510,494,3565287,2020-04-05,1.43188716401715,0.0181338728821514
Connecticut,2020-04-12,525,60,12035,554,3565287,2020-04-06,1.35309122391122,0.0169654107744471
Connecticut,2020-04-13,1346,48,13381,602,3565287,2020-04-07,1.2868855575389,0.0159914007456392
Connecticut,2020-04-14,608,69,13989,671,3565287,2020-04-08,1.17008893470552,0.0148493704704728
Connecticut,2020-04-15,766,197,14755,868,3565287,2020-04-09,1.27386211025029,0.0152528259367979
Connecticut,2020-04-16,1129,103,15884,971,3565287,2020-04-10,1.0640737023611,0.0136229510973201
Connecticut,2020-04-17,925,65,16809,1036,3565287,2020-04-11,1.07634332988948,0.0135908869187457
Connecticut,2020-04-18,741,50,17550,1086,3565287,2020-04-12,1.02929841621121,0.0132430154785915
Connecticut,2020-04-19,412,41,17962,1127,3565287,2020-04-13,1.00607589523067,0.0130670227221513
Connecticut,2020-04-20,1853,204,19815,1331,3565287,2020-04-14,1.09443800056361,0.0136432201917042
Connecticut,2020-04-21,545,92,20360,1423,3565287,2020-04-15,1.06799442252037,0.0133792294269435
Connecticut,2020-04-22,2109,121,22469,1544,3565287,2020-04-16,1.27376110647419,0.0145017368006537
Connecticut,2020-04-23,631,95,23100,1639,3565287,2020-04-17,1.13469059907669,0.0133566979253754
Connecticut,2020-04-24,836,128,23936,1767,3565287,2020-04-18,1.08328650102852,0.0128309698909801
Connecticut,2020-04-25,647,98,24583,1865,3565287,2020-04-19,1.05402140901297,0.0125674813743502
Connecticut,2020-04-26,686,59,25269,1924,3565287,2020-04-20,1.08554822422374,0.0126984248142616
Connecticut,2020-04-27,728,88,25997,2012,3565287,2020-04-21,0.905510204737547,0.0115157897135122
Connecticut,2020-04-28,315,75,26312,2087,3565287,2020-04-22,0.886271425249496,0.0114867932931788
Connecticut,2020-04-29,455,82,26767,2169,3565287,2020-04-23,0.659171417032587,0.0100534389426602
Connecticut,2020-04-30,933,88,27700,2257,3565287,2020-04-24,0.756303459584373,0.0111498742757869
Connecticut,2020-05-01,1064,82,28764,2339,3565287,2020-04-25,0.844284271924474,0.0121495473023443
Connecticut,2020-05-02,523,97,29287,2436,3565287,2020-04-26,0.849101467865402,0.0123788351026094
Connecticut,2020-05-03,0,0,29287,2436,3565287,2020-04-27,0.745290013459147,0.011756181945017
Connecticut,2020-05-04,686,120,29973,2556,3565287,2020-04-28,0.774186094519504,0.012276302208456
Connecticut,2020-05-05,648,77,30621,2633,3565287,2020-04-29,0.880961808305442,0.0134189472625977
Connecticut,2020-05-06,374,85,30995,2718,3565287,2020-04-30,0.885405824027262,0.0136151845289285
Connecticut,2020-05-07,789,79,31784,2797,3565287,2020-05-01,0.87076864231326,0.0136240663694683
Connecticut,2020-05-08,627,77,32411,2874,3565287,2020-05-02,0.795890830542193,0.0131772894718063
Connecticut,2020-05-09,573,58,32984,2932,3565287,2020-05-03,0.838695340746783,0.0137917944835259
Connecticut,2020-05-10,570,35,33554,2967,3565287,2020-05-04,1.00193755744643,0.0153365774086789
Delaware,2020-03-08,0,0,0,0,973764,2020-03-02,5,5
Delaware,2020-03-09,0,0,0,0,973764,2020-03-03,5,5
Delaware,2020-03-10,0,0,0,0,973764,2020-03-04,5,5
Delaware,2020-03-11,1,0,1,0,973764,2020-03-05,10,7.07106781186548
Delaware,2020-03-12,0,0,1,0,973764,2020-03-06,5.21231403354432,3.68566259879299
Delaware,2020-03-13,3,0,4,0,973764,2020-03-07,8.59464099380632,3.84364030087146
Delaware,2020-03-14,2,0,6,0,973764,2020-03-08,5.551056178438,2.09810202312793
Delaware,2020-03-15,0,0,6,0,973764,2020-03-09,3.02034280852989,1.14158227793321
Delaware,2020-03-16,2,0,8,0,973764,2020-03-10,2.83762075924623,0.945873586415411
Delaware,2020-03-17,8,0,16,0,973764,2020-03-11,4.10765923616889,0.996253700280488
Delaware,2020-03-18,3,0,19,0,973764,2020-03-12,2.94044107084591,0.674583446171255
Delaware,2020-03-19,11,0,30,0,973764,2020-03-13,3.32264407535004,0.606629036876703
Delaware,2020-03-20,9,0,39,0,973764,2020-03-14,2.78036072561218,0.463393454268696
Delaware,2020-03-21,6,0,45,0,973764,2020-03-15,2.26963621712468,0.358860995306123
Delaware,2020-03-22,11,0,56,0,973764,2020-03-16,2.31401286018857,0.324026612230675
Delaware,2020-03-23,12,0,68,0,973764,2020-03-17,2.21605197887103,0.283736381143766
Delaware,2020-03-24,36,0,104,0,973764,2020-03-18,2.60806176732845,0.27645399442938
Delaware,2020-03-25,15,0,119,0,973764,2020-03-19,2.26048035034525,0.224926201633243
Delaware,2020-03-26,11,1,130,1,973764,2020-03-20,1.79168705321745,0.178279525116911
Delaware,2020-03-27,33,1,163,2,973764,2020-03-21,1.91135944238754,0.170957185704586
Delaware,2020-03-28,51,3,214,5,973764,2020-03-22,2.22391900578533,0.17056680154696
Delaware,2020-03-29,18,1,232,6,973764,2020-03-23,1.87057577208727,0.140601084916772
Delaware,2020-03-30,32,0,264,6,973764,2020-03-24,1.75888835044888,0.125315606227583
Delaware,2020-03-31,55,4,319,10,973764,2020-03-25,1.68200803131741,0.114446150555303
Delaware,2020-04-01,49,1,368,11,973764,2020-03-26,1.71827282820066,0.108673115573866
Delaware,2020-04-02,25,1,393,12,973764,2020-03-27,1.59388140510965,0.0980966192995904
Delaware,2020-04-03,57,2,450,14,973764,2020-03-28,1.55398874765164,0.0915696651126724
Delaware,2020-04-04,143,0,593,14,973764,2020-03-29,1.85327297441092,0.0950708976125036
Delaware,2020-04-05,80,0,673,14,973764,2020-03-30,1.85500528714568,0.0882336036495328
Delaware,2020-04-06,110,1,783,15,973764,2020-03-31,1.85648405257897,0.0814122113015
Delaware,2020-04-07,145,1,928,16,973764,2020-04-01,1.85909452572457,0.0752725371248478
Delaware,2020-04-08,188,3,1116,19,973764,2020-04-02,1.94796199683376,0.0711769822710852
Delaware,2020-04-09,93,4,1209,23,973764,2020-04-03,1.78862864800021,0.0625761953211077
Delaware,2020-04-10,117,9,1326,32,973764,2020-04-04,1.65234399142764,0.0557956920763956
Delaware,2020-04-11,153,1,1479,33,973764,2020-04-05,1.47970985658867,0.0496837945002971
Delaware,2020-04-12,146,2,1625,35,973764,2020-04-06,1.45261405147174,0.047054784691509
Delaware,2020-04-13,133,6,1758,41,973764,2020-04-07,1.3718809431838,0.0439128389011631
Delaware,2020-04-14,168,2,1926,43,973764,2020-04-08,1.31011751963316,0.0414502839711747
Delaware,2020-04-15,88,3,2014,46,973764,2020-04-09,1.11429071789994,0.0371636761550744
Delaware,2020-04-16,56,9,2070,55,973764,2020-04-10,1.04603979779787,0.0356282569004507
Delaware,2020-04-17,247,6,2317,61,973764,2020-04-11,1.20203201451714,0.0381645546254929
Delaware,2020-04-18,221,6,2538,67,973764,2020-04-12,1.24510242333126,0.0382430169305255
Delaware,2020-04-19,0,0,2538,67,973764,2020-04-13,1.02298505714627,0.0338373381990145
Delaware,2020-04-20,207,5,2745,72,973764,2020-04-14,1.0968831571887,0.0348965019841967
Delaware,2020-04-21,186,10,2931,82,973764,2020-04-15,1.10532420005364,0.0348490295141164
Delaware,2020-04-22,269,7,3200,89,973764,2020-04-16,1.27818160680658,0.0370994271906706
Delaware,2020-04-23,108,3,3308,92,973764,2020-04-17,1.26884767744286,0.0360473908829617
Delaware,2020-04-24,134,8,3442,100,973764,2020-04-18,1.09009682699017,0.0324859730928937
Delaware,2020-04-25,134,12,3576,112,973764,2020-04-19,0.985305859827719,0.0305677372651604
Delaware,2020-04-26,458,8,4034,120,973764,2020-04-20,1.42958232523737,0.0369486240346895
Delaware,2020-04-27,128,5,4162,125,973764,2020-04-21,1.26190172184144,0.0335110022939268
Delaware,2020-04-28,413,12,4575,137,973764,2020-04-22,1.37405268131152,0.03387820820972
Delaware,2020-04-29,80,7,4655,144,973764,2020-04-23,1.13677477317492,0.0297915939371818
Delaware,2020-04-30,79,8,4734,152,973764,2020-04-24,1.0777494539964,0.0285302662731291
Delaware,2020-05-01,184,7,4918,159,973764,2020-04-25,1.10512056420372,0.0287553999688807
Delaware,2020-05-02,120,9,5038,168,973764,2020-04-26,1.07711571918264,0.0281604895781511
Delaware,2020-05-03,170,9,5208,177,973764,2020-04-27,0.852946974273021,0.0248830206300978
Delaware,2020-05-04,80,5,5288,182,973764,2020-04-28,0.841861066535744,0.0250771667151664
Delaware,2020-05-05,83,5,5371,187,973764,2020-04-29,0.620417596915651,0.0219763187979219
Delaware,2020-05-06,407,6,5778,193,973764,2020-04-30,0.946648947787406,0.028236170840344
Delaware,2020-05-07,161,9,5939,202,973764,2020-05-01,1.04267656422703,0.0300245120643128
Delaware,2020-05-08,172,11,6111,213,973764,2020-05-02,1.01602613657989,0.0294037496642203
Delaware,2020-05-09,166,8,6277,221,973764,2020-05-03,1.04635899086912,0.0297145985867465
Delaware,2020-05-10,0,0,6277,221,973764,2020-05-04,0.89398015783237,0.0273297708782895
Diamond Princess,2020-03-08,0,0,0,0,0,2020-03-02,5,5
Diamond Princess,2020-03-09,0,0,0,0,0,2020-03-03,5,5
Diamond Princess,2020-03-10,0,0,0,0,0,2020-03-04,5,5
Diamond Princess,2020-03-11,0,0,0,0,0,2020-03-05,5,5
Diamond Princess,2020-03-12,0,0,0,0,0,2020-03-06,5,5
Diamond Princess,2020-03-13,0,0,0,0,0,2020-03-07,5,5
Diamond Princess,2020-03-14,0,0,0,0,0,2020-03-08,5,5
Diamond Princess,2020-03-15,0,0,0,0,0,2020-03-09,5,5
Diamond Princess,2020-03-16,0,0,0,0,0,2020-03-10,5,5
Diamond Princess,2020-03-17,47,0,47,0,0,2020-03-11,240,34.6410161513775
Diamond Princess,2020-03-18,0,0,47,0,0,2020-03-12,5.43341899490364,0.784246479831911
Diamond Princess,2020-03-19,0,0,47,0,0,2020-03-13,2.64570391930173,0.381874467501226
Diamond Princess,2020-03-20,2,0,49,0,0,2020-03-14,2.06907817872223,0.292611842195921
Diamond Princess,2020-03-21,0,0,49,0,0,2020-03-15,1.72418823240992,0.24383703823582
Diamond Princess,2020-03-22,0,0,49,0,0,2020-03-16,1.52203435014124,0.215248162036746
Diamond Princess,2020-03-23,0,0,49,0,0,2020-03-17,1.39508458727251,0.197294754397845
Diamond Princess,2020-03-24,0,0,49,0,0,2020-03-18,0.0784896880612945,0.0453160425307981
Diamond Princess,2020-03-25,0,0,49,0,0,2020-03-19,0.0952140263989191,0.0549718437720441
Diamond Princess,2020-03-26,0,0,49,0,0,2020-03-20,0.126257267522794,0.0728946673914317
Diamond Princess,2020-03-27,0,0,49,0,0,2020-03-21,0.0525895938127216,0.0525895938127216
Diamond Princess,2020-03-28,0,0,49,0,0,2020-03-22,0.0656588935971112,0.0656588935971112
Diamond Princess,2020-03-29,0,0,49,0,0,2020-03-23,0.0816778204527643,0.0816778204527643
Diamond Princess,2020-03-30,0,0,49,0,0,2020-03-24,0.100314385492727,0.100314385492727
Diamond Princess,2020-03-31,0,0,49,0,0,2020-03-25,0.122256303128136,0.122256303128136
Diamond Princess,2020-04-01,0,0,49,0,0,2020-03-26,0.148130578957991,0.148130578957991
Diamond Princess,2020-04-02,0,0,49,0,0,2020-03-27,0.178619651876212,0.178619651876212
Diamond Princess,2020-04-03,0,0,49,0,0,2020-03-28,0.2144803002679,0.2144803002679
Diamond Princess,2020-04-04,0,0,49,0,0,2020-03-29,0.256549696826741,0.256549696826741
Diamond Princess,2020-04-05,0,0,49,0,0,2020-03-30,0.305744646376514,0.305744646376514
Diamond Princess,2020-04-06,0,0,49,0,0,2020-03-31,0.363054039159336,0.363054039159336
Diamond Princess,2020-04-07,0,0,49,0,0,2020-04-01,0.429523133759501,0.429523133759501
Diamond Princess,2020-04-08,0,0,49,0,0,2020-04-02,0.506227807364722,0.506227807364722
Diamond Princess,2020-04-09,0,0,49,0,0,2020-04-03,0.594236889585516,0.594236889585516
Diamond Princess,2020-04-10,0,0,49,0,0,2020-04-04,0.694561131314854,0.694561131314854
Diamond Princess,2020-04-11,0,0,49,0,0,2020-04-05,0.808088364316451,0.808088364316451
Diamond Princess,2020-04-12,0,0,49,0,0,2020-04-06,0.93550608821315,0.93550608821315
Diamond Princess,2020-04-13,0,0,49,0,0,2020-04-07,1.07721509560823,1.07721509560823
Diamond Princess,2020-04-14,0,0,49,0,0,2020-04-08,1.23324064578978,1.23324064578978
Diamond Princess,2020-04-15,0,0,49,0,0,2020-04-09,1.4031506921296,1.4031506921296
Diamond Princess,2020-04-16,0,0,49,0,0,2020-04-10,1.58599304131592,1.58599304131592
Diamond Princess,2020-04-17,0,0,49,0,0,2020-04-11,1.78026416396268,1.78026416396268
Diamond Princess,2020-04-18,0,0,49,0,0,2020-04-12,1.98392082338813,1.98392082338813
Diamond Princess,2020-04-19,0,0,49,0,0,2020-04-13,2.19444128946298,2.19444128946298
Diamond Princess,2020-04-20,0,0,49,0,0,2020-04-14,2.4089359693637,2.4089359693637
Diamond Princess,2020-04-21,0,0,49,0,0,2020-04-15,2.62429905093032,2.62429905093032
Diamond Princess,2020-04-22,0,0,49,0,0,2020-04-16,2.83738516006999,2.83738516006999
Diamond Princess,2020-04-23,0,0,49,0,0,2020-04-17,3.04519014425797,3.04519014425797
Diamond Princess,2020-04-24,0,0,49,0,0,2020-04-18,3.24501433189451,3.24501433189451
Diamond Princess,2020-04-25,0,0,49,0,0,2020-04-19,3.43459019878844,3.43459019878844
Diamond Princess,2020-04-26,0,0,49,0,0,2020-04-20,3.61216321944084,3.61216321944084
Diamond Princess,2020-04-27,0,0,49,0,0,2020-04-21,3.77652286520089,3.77652286520089
Diamond Princess,2020-04-28,0,0,49,0,0,2020-04-22,3.92698819025998,3.92698819025998
Diamond Princess,2020-04-29,0,0,49,0,0,2020-04-23,4.06335773194804,4.06335773194804
Diamond Princess,2020-04-30,0,0,49,0,0,2020-04-24,4.18583594109266,4.18583594109266
Diamond Princess,2020-05-01,0,0,49,0,0,2020-04-25,4.29494828483973,4.29494828483973
Diamond Princess,2020-05-02,0,0,49,0,0,2020-04-26,4.39145527965376,4.39145527965376
Diamond Princess,2020-05-03,0,0,49,0,0,2020-04-27,4.47627292485967,4.47627292485967
Diamond Princess,2020-05-04,0,0,49,0,0,2020-04-28,4.55040409340601,4.55040409340601
Diamond Princess,2020-05-05,0,0,49,0,0,2020-04-29,4.61488291180297,4.61488291180297
Diamond Princess,2020-05-06,0,0,49,0,0,2020-04-30,4.67073226707075,4.67073226707075
Diamond Princess,2020-05-07,0,0,49,0,0,2020-05-01,4.71893334901313,4.71893334901313
Diamond Princess,2020-05-08,0,0,49,0,0,2020-05-02,4.76040547750626,4.76040547750626
Diamond Princess,2020-05-09,0,0,49,0,0,2020-05-03,4.79599423436549,4.79599423436549
Diamond Princess,2020-05-10,0,0,49,0,0,2020-05-04,4.82646597130713,4.82646597130713
District of Columbia,2020-03-08,0,0,0,0,705749,2020-03-02,5,5
District of Columbia,2020-03-09,0,0,0,0,705749,2020-03-03,5,5
District of Columbia,2020-03-10,0,0,0,0,705749,2020-03-04,5,5
District of Columbia,2020-03-11,0,0,0,0,705749,2020-03-05,5,5
District of Columbia,2020-03-12,0,0,0,0,705749,2020-03-06,5,5
District of Columbia,2020-03-13,0,0,0,0,705749,2020-03-07,5,5
District of Columbia,2020-03-14,0,0,0,0,705749,2020-03-08,5,5
District of Columbia,2020-03-15,0,0,0,0,705749,2020-03-09,5,5
District of Columbia,2020-03-16,22,0,22,0,705749,2020-03-10,115,23.9791576165636
District of Columbia,2020-03-17,0,0,22,0,705749,2020-03-11,5.42254834064085,1.13067948994489
District of Columbia,2020-03-18,9,0,31,0,705749,2020-03-12,3.72150445082722,0.657875258348961
District of Columbia,2020-03-19,9,0,40,0,705749,2020-03-13,3.13667061668666,0.48986565001341
District of Columbia,2020-03-20,31,1,71,1,705749,2020-03-14,3.8714556961155,0.45625542929776
District of Columbia,2020-03-21,27,-1,98,0,705749,2020-03-15,3.43204352786984,0.344933352912483
District of Columbia,2020-03-22,4,2,102,2,705749,2020-03-16,2.38242188633932,0.234747003754954
District of Columbia,2020-03-23,18,0,120,2,705749,2020-03-17,1.77321839010284,0.178215153676642
District of Columbia,2020-03-24,21,0,141,2,705749,2020-03-18,1.86598876316394,0.170340689606009
District of Columbia,2020-03-25,46,0,187,2,705749,2020-03-19,2.11158642830804,0.168522943385248
District of Columbia,2020-03-26,44,1,231,3,705749,2020-03-20,2.12679975092811,0.153488551088846
District of Columbia,2020-03-27,40,0,271,3,705749,2020-03-21,1.81528336759132,0.128040216487157
District of Columbia,2020-03-28,33,1,304,4,705749,2020-03-22,1.60098883008658,0.111276415939142
District of Columbia,2020-03-29,38,1,342,5,705749,2020-03-23,1.66926591260585,0.107526869883009
District of Columbia,2020-03-30,59,4,401,9,705749,2020-03-24,1.73641746467037,0.103402155272205
District of Columbia,2020-03-31,94,0,495,9,705749,2020-03-25,1.91079619709492,0.101414532209096
District of Columbia,2020-04-01,91,0,586,9,705749,2020-03-26,1.82701505773136,0.0913507528865678
District of Columbia,2020-04-02,67,3,653,12,705749,2020-03-27,1.65229566291649,0.0803373642744408
District of Columbia,2020-04-03,104,3,757,15,705749,2020-03-28,1.68124490429334,0.0761844787424404
District of Columbia,2020-04-04,145,6,902,21,705749,2020-03-29,1.82856153461133,0.0747129988473323
District of Columbia,2020-04-05,100,1,1002,22,705749,2020-03-30,1.73671909943789,0.0675505439760178
District of Columbia,2020-04-06,95,2,1097,24,705749,2020-03-31,1.59146933534896,0.0602811995616952
District of Columbia,2020-04-07,114,-2,1211,22,705749,2020-04-01,1.46390964681791,0.0546707075850251
District of Columbia,2020-04-08,229,5,1440,27,705749,2020-04-02,1.60109752386845,0.0547563799688725
District of Columbia,2020-04-09,83,5,1523,32,705749,2020-04-03,1.46621566738749,0.0496808226276541
District of Columbia,2020-04-10,137,6,1660,38,705749,2020-04-04,1.38834534508754,0.0461756793102552
District of Columbia,2020-04-11,118,9,1778,47,705749,2020-04-05,1.2538913683019,0.0423409030117123
District of Columbia,2020-04-12,97,3,1875,50,705749,2020-04-06,1.19167047565667,0.0403088551257248
District of Columbia,2020-04-13,80,2,1955,52,705749,2020-04-07,1.13402552817902,0.038692451706339
District of Columbia,2020-04-14,103,15,2058,67,705749,2020-04-08,1.09486974610044,0.0375979814436785
District of Columbia,2020-04-15,139,5,2197,72,705749,2020-04-09,0.964567129136351,0.0350346557903185
District of Columbia,2020-04-16,153,9,2350,81,705749,2020-04-10,1.06340048520699,0.0369557215134907
District of Columbia,2020-04-17,126,5,2476,86,705749,2020-04-11,1.04488525516529,0.0365559077276732
District of Columbia,2020-04-18,190,5,2666,91,705749,2020-04-12,1.12643214019257,0.0377793214288611
District of Columbia,2020-04-19,127,5,2793,96,705749,2020-04-13,1.13937096753226,0.037584380244495
District of Columbia,2020-04-20,134,9,2927,105,705749,2020-04-14,1.17237549324201,0.0375846327898387
District of Columbia,2020-04-21,171,7,3098,112,705749,2020-04-15,1.21321292912379,0.037602062344992
District of Columbia,2020-04-22,108,15,3206,127,705749,2020-04-16,1.12915198751143,0.0355297143930609
District of Columbia,2020-04-23,155,12,3361,139,705749,2020-04-17,1.10064170407786,0.0345983755352655
District of Columbia,2020-04-24,167,14,3528,153,705749,2020-04-18,1.12531120292346,0.0346783525042272
District of Columbia,2020-04-25,171,12,3699,165,705749,2020-04-19,1.08073418116412,0.0336092342809547
District of Columbia,2020-04-26,142,13,3841,178,705749,2020-04-20,1.07895361751939,0.0333130986865138
District of Columbia,2020-04-27,51,7,3892,185,705749,2020-04-21,0.980415174984288,0.0315443411884596
District of Columbia,2020-04-28,102,5,3994,190,705749,2020-04-22,0.913737467242396,0.0305088060289061
District of Columbia,2020-04-29,112,15,4106,205,705749,2020-04-23,0.936968055122875,0.031214931689824
District of Columbia,2020-04-30,217,19,4323,224,705749,2020-04-24,1.01868946129465,0.0328268091079936
District of Columbia,2020-05-01,335,7,4658,231,705749,2020-04-25,1.1946455870849,0.0355228482622968
District of Columbia,2020-05-02,139,9,4797,240,705749,2020-04-26,1.11846895888278,0.0337384471108635
District of Columbia,2020-05-03,219,11,5016,251,705749,2020-04-27,1.16156135300571,0.0338718169023909
District of Columbia,2020-05-04,154,7,5170,258,705749,2020-04-28,1.22580843603667,0.034275778971851
District of Columbia,2020-05-05,152,6,5322,264,705749,2020-04-29,1.21856509615049,0.0334261412318196
District of Columbia,2020-05-06,139,13,5461,277,705749,2020-04-30,1.18914404539384,0.0322927195359305
District of Columbia,2020-05-07,193,8,5654,285,705749,2020-05-01,1.12514407637589,0.0308287577881363
District of Columbia,2020-05-08,245,19,5899,304,705749,2020-05-02,1.02372889124883,0.0290485301467327
District of Columbia,2020-05-09,203,7,6102,311,705749,2020-05-03,1.07267062000909,0.0296821118423739
District of Columbia,2020-05-10,170,12,6272,323,705749,2020-05-04,1.023148457741,0.0288583180236647
Florida,2020-03-08,3,2,10,2,21477737,2020-03-02,3.84644601943629,1.15974711116602
Florida,2020-03-09,3,0,13,2,21477737,2020-03-03,2.95259075538007,0.818901335691061
Florida,2020-03-10,2,0,15,2,21477737,2020-03-04,2.31982615117493,0.61999961818393
Florida,2020-03-11,9,0,24,2,21477737,2020-03-05,3.06424581030572,0.638939419662742
Florida,2020-03-12,6,0,30,2,21477737,2020-03-06,2.71967293071583,0.513969873007734
Florida,2020-03-13,20,0,50,2,21477737,2020-03-07,3.46536686918314,0.500182623690924
Florida,2020-03-14,26,0,76,2,21477737,2020-03-08,3.44139334954347,0.411325178734747
Florida,2020-03-15,24,1,100,3,21477737,2020-03-09,2.99576651801303,0.314041661519228
Florida,2020-03-16,1,0,101,3,21477737,2020-03-10,2.08308764227885,0.220806848468303
Florida,2020-03-17,89,2,190,5,21477737,2020-03-11,3.35359312258845,0.252786592889596
Florida,2020-03-18,116,2,306,7,21477737,2020-03-12,3.75732808485975,0.223349971283528
Florida,2020-03-19,126,2,432,9,21477737,2020-03-13,3.42869924316872,0.170795674802613
Florida,2020-03-20,132,2,564,11,21477737,2020-03-14,2.92364990250304,0.128831407498599
Florida,2020-03-21,199,2,763,13,21477737,2020-03-15,2.79825551101885,0.106682491213927
Florida,2020-03-22,241,0,1004,13,21477737,2020-03-16,2.70530951828034,0.0899275312270647
Florida,2020-03-23,223,5,1227,18,21477737,2020-03-17,2.50675761761789,0.0746707279743863
Florida,2020-03-24,185,0,1412,18,21477737,2020-03-18,2.08311204841368,0.0595661323750436
Florida,2020-03-25,270,5,1682,23,21477737,2020-03-19,1.91794542663756,0.0516855658705686
Florida,2020-03-26,675,6,2357,29,21477737,2020-03-20,2.27357789392537,0.0518061950760585
Florida,2020-03-27,543,6,2900,35,21477737,2020-03-21,2.21693037952398,0.0458588013000551
Florida,2020-03-28,863,19,3763,54,21477737,2020-03-22,2.27774372383848,0.041578791370897
Florida,2020-03-29,483,2,4246,56,21477737,2020-03-23,1.96141781089455,0.0344426564909424
Florida,2020-03-30,1227,7,5473,63,21477737,2020-03-24,2.14070996460389,0.0328485875483474
Florida,2020-03-31,1268,22,6741,85,21477737,2020-03-25,2.2015365624992,0.0301552058860517
Florida,2020-04-01,215,2,6956,87,21477737,2020-03-26,1.75372105130394,0.0241462272259798
Florida,2020-04-02,2052,77,9008,164,21477737,2020-03-27,1.90649127306038,0.0233753811673025
Florida,2020-04-03,1260,6,10268,170,21477737,2020-03-28,1.8044439096099,0.0210203096089846
Florida,2020-04-04,1269,25,11537,195,21477737,2020-03-29,1.63559508806796,0.0185492177216493
Florida,2020-04-05,813,26,12350,221,21477737,2020-03-30,1.51286753688086,0.01680445353909
Florida,2020-04-06,974,15,13324,236,21477737,2020-03-31,1.33294588250985,0.0150425814595226
Florida,2020-04-07,1221,47,14545,283,21477737,2020-04-01,1.24508074112113,0.0140932469456001
Florida,2020-04-08,911,26,15456,309,21477737,2020-04-02,1.30062643489065,0.0141064446321372
Florida,2020-04-09,908,45,16364,354,21477737,2020-04-03,1.06907049329442,0.0124639576594788
Florida,2020-04-10,1167,36,17531,390,21477737,2020-04-04,1.03939624060696,0.0121953206579809
Florida,2020-04-11,963,48,18494,438,21477737,2020-04-05,0.996624563064312,0.0119478393506308
Florida,2020-04-12,1401,23,19895,461,21477737,2020-04-06,1.08608788271101,0.0125027793834034
Florida,2020-04-13,1124,38,21019,499,21477737,2020-04-07,1.09534490643616,0.0124858571970394
Florida,2020-04-14,609,72,21628,571,21477737,2020-04-08,0.989186360481954,0.0117527322757856
Florida,2020-04-15,883,25,22511,596,21477737,2020-04-09,0.98644459719567,0.0117433880618532
Florida,2020-04-16,832,72,23343,668,21477737,2020-04-10,0.982547301566201,0.0117604991793593
Florida,2020-04-17,1416,57,24759,725,21477737,2020-04-11,1.02287892181915,0.0120305398760149
Florida,2020-04-18,733,23,25492,748,21477737,2020-04-12,0.987751505509508,0.0118067319510987
Florida,2020-04-19,822,26,26314,774,21477737,2020-04-13,0.907296495070587,0.0113235269785872
Florida,2020-04-20,745,48,27059,822,21477737,2020-04-14,0.869904541446122,0.0111922442761285
Florida,2020-04-21,810,45,27869,867,21477737,2020-04-15,0.925265993708558,0.0117112895517938
Florida,2020-04-22,440,26,28309,893,21477737,2020-04-16,0.875405338386142,0.0114956262739686
Florida,2020-04-23,1339,94,29648,987,21477737,2020-04-17,0.974291815720071,0.0122690820598898
Florida,2020-04-24,885,59,30533,1046,21477737,2020-04-18,0.899541656612623,0.0118370991531039
Florida,2020-04-25,306,9,30839,1055,21477737,2020-04-19,0.846228152775944,0.0115715562356805
Florida,2020-04-26,693,20,31532,1075,21477737,2020-04-20,0.852510351510844,0.0118006522550653
Florida,2020-04-27,606,13,32138,1088,21477737,2020-04-21,0.856493994554713,0.0120169005226357
Florida,2020-04-28,710,83,32848,1171,21477737,2020-04-22,0.864291845631919,0.0122474519473225
Florida,2020-04-29,345,47,33193,1218,21477737,2020-04-23,0.870965946573193,0.0124614589465597
Florida,2020-04-30,497,50,33690,1268,21477737,2020-04-24,0.73917440969507,0.0116250559688764
Florida,2020-05-01,1038,46,34728,1314,21477737,2020-04-25,0.806456195530092,0.012449819154326
Florida,2020-05-02,735,50,35463,1364,21477737,2020-04-26,0.929035661298817,0.0136608120526696
Florida,2020-05-03,615,15,36078,1379,21477737,2020-04-27,0.925893940493063,0.0137308924280563
Florida,2020-05-04,819,20,36897,1399,21477737,2020-04-28,0.978262148311157,0.0141792014716487
Florida,2020-05-05,542,72,37439,1471,21477737,2020-04-29,0.94642443123738,0.0139664169447347
Florida,2020-05-06,563,68,38002,1539,21477737,2020-04-30,0.998057452463071,0.0143907359205911
Florida,2020-05-07,826,61,38828,1600,21477737,2020-05-01,1.06689531124863,0.014882726392871
Florida,2020-05-08,371,69,39199,1669,21477737,2020-05-02,0.914788038442143,0.0136794797164347
Florida,2020-05-09,802,46,40001,1715,21477737,2020-05-03,0.939095016815227,0.0139389302421643
Florida,2020-05-10,595,6,40596,1721,21477737,2020-05-04,0.950309906100885,0.0141365712278313
Georgia,2020-03-08,0,0,5,0,10617423,2020-03-02,2.60182258442196,1.06218962218054
Georgia,2020-03-09,5,0,10,0,10617423,2020-03-03,3.73308844397397,1.1255685161703
Georgia,2020-03-10,7,0,17,0,10617423,2020-03-04,3.71253587885533,0.928133969713833
Georgia,2020-03-11,6,0,23,0,10617423,2020-03-05,3.35490480932014,0.715268108651936
Georgia,2020-03-12,8,1,31,1,10617423,2020-03-06,3.13890786339174,0.573083547570001
Georgia,2020-03-13,11,0,42,1,10617423,2020-03-07,2.95321019815755,0.466943531770753
Georgia,2020-03-14,31,0,73,1,10617423,2020-03-08,3.67998401272431,0.443018014713808
Georgia,2020-03-15,26,0,99,1,10617423,2020-03-09,3.33893759282028,0.342567768919692
Georgia,2020-03-16,22,0,121,1,10617423,2020-03-10,2.66073374105954,0.25141570656436
Georgia,2020-03-17,25,0,146,1,10617423,2020-03-11,2.30146156639622,0.201851532293472
Georgia,2020-03-18,51,2,197,3,10617423,2020-03-12,2.45967582020706,0.18593401503162
Georgia,2020-03-19,90,7,287,10,10617423,2020-03-13,2.81533581386556,0.175615823020234
Georgia,2020-03-20,198,4,485,14,10617423,2020-03-14,3.58013743352067,0.169905803545949
Georgia,2020-03-21,70,6,555,20,10617423,2020-03-15,2.57999438796784,0.117393809483564
Georgia,2020-03-22,66,5,621,25,10617423,2020-03-16,2.07837613587374,0.090881043024404
Georgia,2020-03-23,151,0,772,25,10617423,2020-03-17,2.12955663364479,0.0833998743571728
Georgia,2020-03-24,254,7,1026,32,10617423,2020-03-18,2.36336819469086,0.0796238975848455
Georgia,2020-03-25,221,8,1247,40,10617423,2020-03-19,2.22311662950169,0.0685742220374177
Georgia,2020-03-26,278,8,1525,48,10617423,2020-03-20,2.09524313551838,0.0595249135444588
Georgia,2020-03-27,475,16,2000,64,10617423,2020-03-21,2.10107719456599,0.0539625430625408
Georgia,2020-03-28,366,5,2366,69,10617423,2020-03-22,2.06101441896885,0.0484174523111124
Georgia,2020-03-29,285,11,2651,80,10617423,2020-03-23,1.90446515573717,0.042258888450664
Georgia,2020-03-30,157,7,2808,87,10617423,2020-03-24,1.61474435356249,0.0357773574556664
Georgia,2020-03-31,1121,24,3929,111,10617423,2020-03-25,2.04717182695379,0.0379888363018031
Georgia,2020-04-01,709,28,4638,139,10617423,2020-03-26,2.00176154187899,0.0343703867854118
Georgia,2020-04-02,710,24,5348,163,10617423,2020-03-27,1.86811986176112,0.0302096571205918
Georgia,2020-04-03,483,21,5831,184,10617423,2020-03-28,1.59216711853402,0.0257202923334757
Georgia,2020-04-04,329,17,6160,201,10617423,2020-03-29,1.40688886004071,0.0228377808263321
Georgia,2020-04-05,487,10,6647,211,10617423,2020-03-30,1.37566902205319,0.0217593983860488
Georgia,2020-04-06,667,18,7314,229,10617423,2020-03-31,1.45256852544909,0.0216367910233413
Georgia,2020-04-07,1508,100,8822,329,10617423,2020-04-01,1.45428050467799,0.0207881671289219
Georgia,2020-04-08,1079,33,9901,362,10617423,2020-04-02,1.43533327780703,0.0197831212903873
Georgia,2020-04-09,665,17,10566,379,10617423,2020-04-03,1.31079877290276,0.018144390232891
Georgia,2020-04-10,919,37,11485,416,10617423,2020-04-04,1.33717976875371,0.0177817087492012
Georgia,2020-04-11,674,13,12159,429,10617423,2020-04-05,1.33602991699425,0.0172480720618454
Georgia,2020-04-12,293,4,12452,433,10617423,2020-04-06,1.21341878629798,0.0159247344369107
Georgia,2020-04-13,863,32,13315,465,10617423,2020-04-07,1.20296582613405,0.015527634312153
Georgia,2020-04-14,1263,60,14578,525,10617423,2020-04-08,1.11424672047973,0.0146853144324228
Georgia,2020-04-15,409,27,14987,552,10617423,2020-04-09,0.963905639564935,0.0135146141983568
Georgia,2020-04-16,682,35,15669,587,10617423,2020-04-10,0.976557145909948,0.0136691758128851
Georgia,2020-04-17,1525,63,17194,650,10617423,2020-04-11,1.10605965911015,0.0146372839770932
Georgia,2020-04-18,475,23,17669,673,10617423,2020-04-12,1.05034681618945,0.0141487319156574
Georgia,2020-04-19,632,14,18301,687,10617423,2020-04-13,1.10058592617848,0.0143895105486402
Georgia,2020-04-20,1106,88,19407,775,10617423,2020-04-14,1.12684872278018,0.0144361048507323
Georgia,2020-04-21,474,23,19881,798,10617423,2020-04-15,0.956409267109453,0.0131323369654018
Georgia,2020-04-22,1333,50,21214,848,10617423,2020-04-16,1.12930883000835,0.0143099600703485
Georgia,2020-04-23,669,33,21883,881,10617423,2020-04-17,1.10774546227197,0.0140513940535668
Georgia,2020-04-24,608,18,22491,899,10617423,2020-04-18,0.920800280332319,0.0126505517008246
Georgia,2020-04-25,731,8,23222,907,10617423,2020-04-19,0.978375315917165,0.0131281203489141
Georgia,2020-04-26,264,9,23486,916,10617423,2020-04-20,0.924223130617586,0.0128339569222894
Georgia,2020-04-27,816,79,24302,995,10617423,2020-04-21,0.885208107975172,0.0126509948395349
Georgia,2020-04-28,620,41,24922,1036,10617423,2020-04-22,0.934798267399971,0.0131648670657166
Georgia,2020-04-29,853,65,25775,1101,10617423,2020-04-23,0.859485548596995,0.0127250922195594
Georgia,2020-04-30,489,31,26264,1132,10617423,2020-04-24,0.8475030723125,0.0128028039344872
Georgia,2020-05-01,1225,37,27489,1169,10617423,2020-04-25,0.999400557727224,0.0141350718076739
Georgia,2020-05-02,842,8,28331,1177,10617423,2020-04-26,1.02487601682356,0.0143370856666528
Georgia,2020-05-03,334,7,28665,1184,10617423,2020-04-27,1.02900220469673,0.0142972142524496
Georgia,2020-05-04,786,62,29451,1246,10617423,2020-04-28,1.01485991758507,0.0141417281892558
Georgia,2020-05-05,547,53,29998,1299,10617423,2020-04-29,0.995951317327802,0.0139776618158365
Georgia,2020-05-06,745,28,30743,1327,10617423,2020-04-30,0.974999277153539,0.013831516378584
Georgia,2020-05-07,875,28,31618,1355,10617423,2020-05-01,1.05599462940073,0.0144305196947232
Georgia,2020-05-08,563,45,32181,1400,10617423,2020-05-02,0.916997229241161,0.013385751131528
Georgia,2020-05-09,407,3,32588,1403,10617423,2020-05-03,0.842035117980108,0.0129040897816707
Georgia,2020-05-10,992,3,33580,1406,10617423,2020-05-04,1.00667600312419,0.0143576637795956
Grand Princess,2020-03-08,0,0,0,0,0,2020-03-02,5,5
Grand Princess,2020-03-09,0,0,0,0,0,2020-03-03,5,5
Grand Princess,2020-03-10,0,0,0,0,0,2020-03-04,5,5
Grand Princess,2020-03-11,0,0,0,0,0,2020-03-05,5,5
Grand Princess,2020-03-12,0,0,0,0,0,2020-03-06,5,5
Grand Princess,2020-03-13,0,0,0,0,0,2020-03-07,5,5
Grand Princess,2020-03-14,0,0,0,0,0,2020-03-08,5,5
Grand Princess,2020-03-15,0,0,0,0,0,2020-03-09,5,5
Grand Princess,2020-03-16,20,0,20,0,0,2020-03-10,105,22.9128784747792
Grand Princess,2020-03-17,1,0,21,0,0,2020-03-11,5.67868742184269,1.21070022629646
Grand Princess,2020-03-18,0,0,21,0,0,2020-03-12,2.74353073849817,0.584922718791447
Grand Princess,2020-03-19,1,1,22,1,0,2020-03-13,2.13362435164185,0.444891431500507
Grand Princess,2020-03-20,1,0,23,1,0,2020-03-14,1.84725924776224,0.377070214971248
Grand Princess,2020-03-21,0,0,23,1,0,2020-03-15,1.60648597120238,0.327922575698775
Grand Princess,2020-03-22,7,0,30,1,0,2020-03-16,1.87854177806293,0.337396063418907
Grand Princess,2020-03-23,-2,0,28,1,0,2020-03-17,0.578888165351767,0.174541349095366
Grand Princess,2020-03-24,0,0,28,1,0,2020-03-18,0.565481412379693,0.178820923760877
Grand Princess,2020-03-25,0,0,28,1,0,2020-03-19,0.657000691251318,0.207761860865923
Grand Princess,2020-03-26,0,0,28,1,0,2020-03-20,0.653871320417791,0.21795710680593
Grand Princess,2020-03-27,0,2,28,3,0,2020-03-21,0.635417862580417,0.224654139758837
Grand Princess,2020-03-28,75,0,103,3,0,2020-03-22,7.22938642226985,0.793528250819966
Grand Princess,2020-03-29,0,0,103,3,0,2020-03-23,3.1175226770353,0.357604376405086
Grand Princess,2020-03-30,0,0,103,3,0,2020-03-24,2.03802556256267,0.233777565041139
Grand Princess,2020-03-31,0,0,103,3,0,2020-03-25,1.68870082865024,0.19370726994631
Grand Princess,2020-04-01,0,0,103,3,0,2020-03-26,1.49517468294584,0.171508298576353
Grand Princess,2020-04-02,0,0,103,3,0,2020-03-27,1.37298397792538,0.157492063444137
Grand Princess,2020-04-03,0,0,103,3,0,2020-03-28,1.28950648469475,0.147916538258547
Grand Princess,2020-04-04,0,0,103,3,0,2020-03-29,0.0161778873976623,0.0161778873976623
Grand Princess,2020-04-05,0,0,103,3,0,2020-03-30,0.0198558042920244,0.0198558042920244
Grand Princess,2020-04-06,0,0,103,3,0,2020-03-31,0.0267328781260943,0.0267328781260943
Grand Princess,2020-04-07,0,0,103,3,0,2020-04-01,0.0340701625151866,0.0340701625151866
Grand Princess,2020-04-08,0,0,103,3,0,2020-04-02,0.042547986035913,0.042547986035913
Grand Princess,2020-04-09,0,0,103,3,0,2020-04-03,0.0525096587566032,0.0525096587566032
Grand Princess,2020-04-10,0,0,103,3,0,2020-04-04,0.064283603702011,0.064283603702011
Grand Princess,2020-04-11,0,0,103,3,0,2020-04-05,0.0782270819709124,0.0782270819709124
Grand Princess,2020-04-12,0,-3,103,0,0,2020-04-06,0.0947433793670262,0.0947433793670262
Grand Princess,2020-04-13,0,0,103,0,0,2020-04-07,0.114292594154182,0.114292594154182
Grand Princess,2020-04-14,0,0,103,0,0,2020-04-08,0.137400134895902,0.137400134895902
Grand Princess,2020-04-15,0,0,103,0,0,2020-04-09,0.164663835114248,0.164663835114248
Grand Princess,2020-04-16,0,0,103,0,0,2020-04-10,0.196759568244782,0.196759568244782
Grand Princess,2020-04-17,0,0,103,0,0,2020-04-11,0.234444733101298,0.234444733101298
Grand Princess,2020-04-18,0,0,103,0,0,2020-04-12,0.278558599025039,0.278558599025039
Grand Princess,2020-04-19,0,0,103,0,0,2020-04-13,0.330018155906434,0.330018155906434
Grand Princess,2020-04-20,0,0,103,0,0,2020-04-14,0.389807801992958,0.389807801992958
Grand Princess,2020-04-21,0,0,103,0,0,2020-04-15,0.45896096356446,0.45896096356446
Grand Princess,2020-04-22,0,0,103,0,0,2020-04-16,0.538531655342754,0.538531655342754
Grand Princess,2020-04-23,0,3,103,3,0,2020-04-17,0.629554174516159,0.629554174516159
Grand Princess,2020-04-24,0,0,103,3,0,2020-04-18,0.732989716126508,0.732989716126508
Grand Princess,2020-04-25,0,0,103,3,0,2020-04-19,0.849659846080212,0.849659846080212
Grand Princess,2020-04-26,0,0,103,3,0,2020-04-20,0.980168567447215,0.980168567447215
Grand Princess,2020-04-27,0,0,103,3,0,2020-04-21,1.12481714722779,1.12481714722779
Grand Princess,2020-04-28,0,0,103,3,0,2020-04-22,1.28351871807116,1.28351871807116
Grand Princess,2020-04-29,0,0,103,3,0,2020-04-23,1.45572245404657,1.45572245404657
Grand Princess,2020-04-30,0,0,103,3,0,2020-04-24,1.64035910412321,1.64035910412321
Grand Princess,2020-05-01,0,0,103,3,0,2020-04-25,1.83581997458974,1.83581997458974
Grand Princess,2020-05-02,0,0,103,3,0,2020-04-26,2.03997932719636,2.03997932719636
Grand Princess,2020-05-03,0,0,103,3,0,2020-04-27,2.25026532034622,2.25026532034622
Grand Princess,2020-05-04,0,0,103,3,0,2020-04-28,2.46377756457479,2.46377756457479
Grand Princess,2020-05-05,0,0,103,3,0,2020-04-29,2.67744144422679,2.67744144422679
Grand Princess,2020-05-06,0,0,103,3,0,2020-04-30,2.88818250149791,2.88818250149791
Grand Princess,2020-05-07,0,0,103,3,0,2020-05-01,3.09310026797178,3.09310026797178
Grand Princess,2020-05-08,0,0,103,3,0,2020-05-02,3.28962110103052,3.28962110103052
Grand Princess,2020-05-09,0,0,103,3,0,2020-05-03,3.47561377395385,3.47561377395385
Grand Princess,2020-05-10,0,0,103,3,0,2020-05-04,3.64945854621371,3.64945854621371
Guam,2020-03-08,0,0,0,0,164229,2020-03-02,5,5
Guam,2020-03-09,0,0,0,0,164229,2020-03-03,5,5
Guam,2020-03-10,0,0,0,0,164229,2020-03-04,5,5
Guam,2020-03-11,0,0,0,0,164229,2020-03-05,5,5
Guam,2020-03-12,0,0,0,0,164229,2020-03-06,5,5
Guam,2020-03-13,0,0,0,0,164229,2020-03-07,5,5
Guam,2020-03-14,0,0,0,0,164229,2020-03-08,5,5
Guam,2020-03-15,0,0,0,0,164229,2020-03-09,5,5
Guam,2020-03-16,3,0,3,0,164229,2020-03-10,20,10
Guam,2020-03-17,0,0,3,0,164229,2020-03-11,5.32537930968356,2.66268965484178
Guam,2020-03-18,2,0,5,0,164229,2020-03-12,4.46005928794971,1.82081157967294
Guam,2020-03-19,7,0,12,0,164229,2020-03-13,6.19898736457884,1.7192897537648
Guam,2020-03-20,2,0,14,0,164229,2020-03-14,3.69071346528333,0.952938119111053
Guam,2020-03-21,1,0,15,0,164229,2020-03-15,2.54174929231937,0.635437323079843
Guam,2020-03-22,12,1,27,1,164229,2020-03-16,3.4414104624557,0.650365445925254
Guam,2020-03-23,2,0,29,1,164229,2020-03-17,2.29843099107275,0.442333250469876
Guam,2020-03-24,3,0,32,1,164229,2020-03-18,1.99967865765147,0.365089702852454
Guam,2020-03-25,5,0,37,1,164229,2020-03-19,1.86148124628473,0.324042291958737
Guam,2020-03-26,8,0,45,1,164229,2020-03-20,1.65429788221089,0.283709746203417
Guam,2020-03-27,6,0,51,1,164229,2020-03-21,1.64921823513602,0.267538525858532
Guam,2020-03-28,4,0,55,1,164229,2020-03-22,1.59490503563818,0.249082319270697
Guam,2020-03-29,1,0,56,1,164229,2020-03-23,1.05098371561232,0.191882496203821
Guam,2020-03-30,2,0,58,1,164229,2020-03-24,1.04086038962217,0.190034238203226
Guam,2020-03-31,11,1,69,2,164229,2020-03-25,1.3393917210327,0.217278028436702
Guam,2020-04-01,8,1,77,3,164229,2020-03-26,1.3760870293164,0.214908688054459
Guam,2020-04-02,5,0,82,3,164229,2020-03-27,1.18822180142905,0.192755029246375
Guam,2020-04-03,2,1,84,4,164229,2020-03-28,1.02626997650686,0.176003848945163
Guam,2020-04-04,9,0,93,4,164229,2020-03-29,1.18063523210521,0.189052940034248
Guam,2020-04-05,19,0,112,4,164229,2020-03-30,1.68974323011578,0.223811958341995
Guam,2020-04-06,1,0,113,4,164229,2020-03-31,1.4738480261762,0.196951226933013
Guam,2020-04-07,8,0,121,4,164229,2020-04-01,1.26088607535439,0.173196022385728
Guam,2020-04-08,0,0,121,4,164229,2020-04-02,1.02039098525044,0.152110907109865
Guam,2020-04-09,7,0,128,4,164229,2020-04-03,1.0675334981438,0.155715764630463
Guam,2020-04-10,2,0,130,4,164229,2020-04-04,1.06856431793114,0.155866125149979
Guam,2020-04-11,3,1,133,5,164229,2020-04-05,0.925218231267969,0.144494811745041
Guam,2020-04-12,0,0,133,5,164229,2020-04-06,0.505852747435831,0.107848168123773
Guam,2020-04-13,0,0,133,5,164229,2020-04-07,0.53768591234884,0.117332685402378
Guam,2020-04-14,0,0,133,5,164229,2020-04-08,0.376255828185474,0.104354590862684
Guam,2020-04-15,2,0,135,5,164229,2020-04-09,0.499039100277236,0.128851341632005
Guam,2020-04-16,0,0,135,5,164229,2020-04-10,0.300546265452765,0.106259151180971
Guam,2020-04-17,1,0,136,5,164229,2020-04-11,0.304464681682788,0.115076832962157
Guam,2020-04-18,0,0,136,5,164229,2020-04-12,0.204417685320318,0.102208842660159
Guam,2020-04-19,0,0,136,5,164229,2020-04-13,0.243238618200729,0.121619309100364
Guam,2020-04-20,0,0,136,5,164229,2020-04-14,0.288427474976815,0.144213737488408
Guam,2020-04-21,0,0,136,5,164229,2020-04-15,0.335864714684184,0.167932357342092
Guam,2020-04-22,0,0,136,5,164229,2020-04-16,0.19311345835951,0.136551835944395
Guam,2020-04-23,3,0,139,5,164229,2020-04-17,0.57217584996419,0.25588481912073
Guam,2020-04-24,2,0,141,5,164229,2020-04-18,0.761700816881944,0.310963056336981
Guam,2020-04-25,0,0,141,5,164229,2020-04-19,0.792886698217845,0.323694639078972
Guam,2020-04-26,0,0,141,5,164229,2020-04-20,0.824569132582832,0.336628938746212
Guam,2020-04-27,0,0,141,5,164229,2020-04-21,0.859684449834923,0.350964706983474
Guam,2020-04-28,0,0,141,5,164229,2020-04-22,0.893839489898023,0.364908443699959
Guam,2020-04-29,0,0,141,5,164229,2020-04-23,0.925781050500884,0.377948531210825
Guam,2020-04-30,4,0,145,5,164229,2020-04-24,1.11417910466112,0.421120118131131
Guam,2020-05-01,0,0,145,5,164229,2020-04-25,0.793946555546128,0.355063693740591
Guam,2020-05-02,0,0,145,5,164229,2020-04-26,0.835370937554057,0.373589240559721
Guam,2020-05-03,0,0,145,5,164229,2020-04-27,0.893400064653368,0.399540655133528
Guam,2020-05-04,0,0,145,5,164229,2020-04-28,0.937494492444155,0.419260282727359
Guam,2020-05-05,0,0,145,5,164229,2020-04-29,0.97450311460018,0.435811041706254
Guam,2020-05-06,4,0,149,5,164229,2020-04-30,1.81107572686981,0.603691908956602
Guam,2020-05-07,0,0,149,5,164229,2020-05-01,0.897107601941992,0.401198716214823
Guam,2020-05-08,2,0,151,5,164229,2020-05-02,1.2672356929967,0.478970070881981
Guam,2020-05-09,0,0,151,5,164229,2020-05-03,1.26731257149823,0.478999128224297
Guam,2020-05-10,0,0,151,5,164229,2020-05-04,1.22500445481054,0.463008163196422
Hawaii,2020-03-08,0,0,1,0,1415872,2020-03-02,5.21231403354432,3.68566259879299
Hawaii,2020-03-09,0,0,1,0,1415872,2020-03-03,3.43785639752253,2.43093157143374
Hawaii,2020-03-10,2,0,3,0,1415872,2020-03-04,5.6345878448971,2.81729392244855
Hawaii,2020-03-11,-1,0,2,0,1415872,2020-03-05,3.41196747263421,1.70598373631711
Hawaii,2020-03-12,0,0,2,0,1415872,2020-03-06,2.43610115130762,1.21805057565381
Hawaii,2020-03-13,0,0,2,0,1415872,2020-03-07,2.04456676772861,1.0222833838643
Hawaii,2020-03-14,2,0,4,0,1415872,2020-03-08,2.27988883446326,1.01959728300052
Hawaii,2020-03-15,2,0,6,0,1415872,2020-03-09,2.73269433155708,1.03286137292227
Hawaii,2020-03-16,2,0,8,0,1415872,2020-03-10,2.74885749808016,0.916285832693388
Hawaii,2020-03-17,2,0,10,0,1415872,2020-03-11,2.10075137259139,0.700250457530463
Hawaii,2020-03-18,5,0,15,0,1415872,2020-03-12,2.73022602058521,0.72968359696322
Hawaii,2020-03-19,10,0,25,0,1415872,2020-03-13,3.61186606970967,0.737269074171703
Hawaii,2020-03-20,11,0,36,0,1415872,2020-03-14,3.52401814121062,0.595667785156926
Hawaii,2020-03-21,0,0,36,0,1415872,2020-03-15,2.20928520568021,0.384587189942413
Hawaii,2020-03-22,17,0,53,0,1415872,2020-03-16,2.55375019780798,0.368602091036874
Hawaii,2020-03-23,3,0,56,0,1415872,2020-03-17,2.0316177339024,0.2902311048432
Hawaii,2020-03-24,34,1,90,1,1415872,2020-03-18,2.766342758827,0.307371417647444
Hawaii,2020-03-25,1,-1,91,0,1415872,2020-03-19,1.98094460216536,0.225749588797373
Hawaii,2020-03-26,4,0,95,0,1415872,2020-03-20,1.50092783581047,0.178127362581246
Hawaii,2020-03-27,11,0,106,0,1415872,2020-03-21,1.37216865486493,0.162846459154223
Hawaii,2020-03-28,43,0,149,0,1415872,2020-03-22,2.077535046686,0.194578984778982
Hawaii,2020-03-29,0,0,149,0,1415872,2020-03-23,1.4826107231981,0.150536311218517
Hawaii,2020-03-30,26,0,175,0,1415872,2020-03-24,1.64390787618817,0.150067571041445
Hawaii,2020-03-31,29,0,204,0,1415872,2020-03-25,1.41708431966994,0.132143794177418
Hawaii,2020-04-01,20,1,224,1,1415872,2020-03-26,1.51984883340756,0.131294941883745
Hawaii,2020-04-02,32,0,256,1,1415872,2020-03-27,1.68098896482727,0.132070966236569
Hawaii,2020-04-03,63,2,319,3,1415872,2020-03-28,1.96193703116816,0.13411525442151
Hawaii,2020-04-04,32,0,351,3,1415872,2020-03-29,1.56550163017584,0.109876674129004
Hawaii,2020-04-05,20,1,371,4,1415872,2020-03-30,1.52916592919651,0.102400524605741
Hawaii,2020-04-06,16,1,387,5,1415872,2020-03-31,1.3305590099455,0.0911684011373953
Hawaii,2020-04-07,23,0,410,5,1415872,2020-04-01,1.21354549361233,0.0843472425107264
Hawaii,2020-04-08,0,0,410,5,1415872,2020-04-02,1.0581387237058,0.0773787669547126
Hawaii,2020-04-09,32,1,442,6,1415872,2020-04-03,1.05138833416684,0.0768851295825174
Hawaii,2020-04-10,0,0,442,6,1415872,2020-04-04,0.696545305363137,0.0625516149725392
Hawaii,2020-04-11,23,2,465,8,1415872,2020-04-05,0.68731853330727,0.064092783710171
Hawaii,2020-04-12,34,1,499,9,1415872,2020-04-06,0.836946653524348,0.073689043964171
Hawaii,2020-04-13,5,0,504,9,1415872,2020-04-07,0.798711882281815,0.0735273885842432
Hawaii,2020-04-14,7,0,511,9,1415872,2020-04-08,0.717571506663626,0.071050166423306
Hawaii,2020-04-15,13,0,524,9,1415872,2020-04-09,0.858007241116178,0.0800095877845842
Hawaii,2020-04-16,6,0,530,9,1415872,2020-04-10,0.687536069219239,0.0728786775800299
Hawaii,2020-04-17,11,0,541,9,1415872,2020-04-11,0.818102218027536,0.0818102218027536
Hawaii,2020-04-18,33,0,574,9,1415872,2020-04-12,0.940985721254343,0.0897194682230297
Hawaii,2020-04-19,6,1,580,10,1415872,2020-04-13,0.708414055695817,0.0782312452633604
Hawaii,2020-04-20,4,0,584,10,1415872,2020-04-14,0.736220411459943,0.0818022679399936
Hawaii,2020-04-21,2,0,586,10,1415872,2020-04-15,0.734513650985333,0.0842544941393729
Hawaii,2020-04-22,6,2,592,12,1415872,2020-04-16,0.704129285114052,0.084767204671128
Hawaii,2020-04-23,4,0,596,12,1415872,2020-04-17,0.726286569605367,0.0887300266521347
Hawaii,2020-04-24,5,1,601,13,1415872,2020-04-18,0.700182195306941,0.0896491436716663
Hawaii,2020-04-25,4,0,605,13,1415872,2020-04-19,0.389986514123173,0.0689405271769497
Hawaii,2020-04-26,1,1,606,14,1415872,2020-04-20,0.372575094663055,0.0717021103990216
Hawaii,2020-04-27,1,2,607,16,1415872,2020-04-21,0.383459770400243,0.0782733978637823
Hawaii,2020-04-28,2,0,609,16,1415872,2020-04-22,0.438121012598841,0.0894310772048868
Hawaii,2020-04-29,4,0,613,16,1415872,2020-04-23,0.451444674753104,0.0962483280522874
Hawaii,2020-04-30,5,0,618,16,1415872,2020-04-24,0.526314587513135,0.109744177824992
Hawaii,2020-05-01,1,0,619,16,1415872,2020-04-25,0.477646439412128,0.109579608428394
Hawaii,2020-05-02,1,0,620,16,1415872,2020-04-26,0.444512635113364,0.111128158778341
Hawaii,2020-05-03,0,1,620,17,1415872,2020-04-27,0.466468659095955,0.120441689880423
Hawaii,2020-05-04,1,0,621,17,1415872,2020-04-28,0.520416119391891,0.134370864233512
Hawaii,2020-05-05,4,0,625,17,1415872,2020-04-29,0.649330637747943,0.157485812081438
Hawaii,2020-05-06,1,0,626,17,1415872,2020-04-30,0.572475772325698,0.15300058587654
Hawaii,2020-05-07,3,0,629,17,1415872,2020-05-01,0.530843705957871,0.153241378266198
Hawaii,2020-05-08,0,0,629,17,1415872,2020-05-02,0.536192027611282,0.161667979196955
Hawaii,2020-05-09,2,0,631,17,1415872,2020-05-03,0.64509557290065,0.186223051333613
Hawaii,2020-05-10,1,0,632,17,1415872,2020-05-04,0.753498972115807,0.208983013844073
Idaho,2020-03-08,0,0,0,0,1787065,2020-03-02,5,5
Idaho,2020-03-09,0,0,0,0,1787065,2020-03-03,5,5
Idaho,2020-03-10,0,0,0,0,1787065,2020-03-04,5,5
Idaho,2020-03-11,0,0,0,0,1787065,2020-03-05,5,5
Idaho,2020-03-12,0,0,0,0,1787065,2020-03-06,5,5
Idaho,2020-03-13,1,0,1,0,1787065,2020-03-07,10,7.07106781186548
Idaho,2020-03-14,1,0,2,0,1787065,2020-03-08,7.81847105031648,4.51399636555151
Idaho,2020-03-15,2,0,4,0,1787065,2020-03-09,6.53198070257572,2.92119057573523
Idaho,2020-03-16,0,0,4,0,1787065,2020-03-10,3.42683470945268,1.53252707159839
Idaho,2020-03-17,4,0,8,0,1787065,2020-03-11,4.33036350821803,1.44345450273934
Idaho,2020-03-18,1,0,9,0,1787065,2020-03-12,3.08831471676289,0.976610863638853
Idaho,2020-03-19,14,0,23,0,1787065,2020-03-13,5.29140864406061,1.08010426654173
Idaho,2020-03-20,13,0,36,0,1787065,2020-03-14,4.46097123315302,0.743495205525503
Idaho,2020-03-21,6,0,42,0,1787065,2020-03-15,2.98049353315797,0.465474887357943
Idaho,2020-03-22,0,0,42,0,1787065,2020-03-16,2.01071211599451,0.321971618967721
Idaho,2020-03-23,26,0,68,0,1787065,2020-03-17,2.78675578862228,0.345654514606705
Idaho,2020-03-24,13,0,81,0,1787065,2020-03-18,2.39735893148245,0.27868731500624
Idaho,2020-03-25,10,0,91,0,1787065,2020-03-19,2.08171625250415,0.228498043964629
Idaho,2020-03-26,55,3,146,3,1787065,2020-03-20,2.56198484062131,0.230073030543904
Idaho,2020-03-27,59,0,205,3,1787065,2020-03-21,2.70866724846086,0.207745294600702
Idaho,2020-03-28,29,1,234,4,1787065,2020-03-22,2.28645644183017,0.164582736023017
Idaho,2020-03-29,47,1,281,5,1787065,2020-03-23,2.24349894757472,0.14481723435318
Idaho,2020-03-30,59,1,340,6,1787065,2020-03-24,2.0506017911867,0.124108066256616
Idaho,2020-03-31,175,2,515,8,1787065,2020-03-25,2.69514548609134,0.129222335274479
Idaho,2020-04-01,51,1,566,9,1787065,2020-03-26,2.22678172621193,0.102064373081418
Idaho,2020-04-02,210,0,776,9,1787065,2020-03-27,2.33650662763221,0.0930148601948471
Idaho,2020-04-03,115,0,891,9,1787065,2020-03-28,2.01795826424514,0.0769899098876304
Idaho,2020-04-04,131,1,1022,10,1787065,2020-03-29,1.91288211813802,0.06810040672836
Idaho,2020-04-05,56,0,1078,10,1787065,2020-03-30,1.64079178220355,0.0580833994693681
Idaho,2020-04-06,23,0,1101,10,1787065,2020-03-31,1.38704479635309,0.0502473314094057
Idaho,2020-04-07,69,3,1170,13,1787065,2020-04-01,1.11214856142559,0.043422106154209
Idaho,2020-04-08,40,2,1210,15,1787065,2020-04-02,1.07528739409806,0.0423393997955611
Idaho,2020-04-09,22,3,1232,18,1787065,2020-04-03,0.759936145696104,0.0355483135207492
Idaho,2020-04-10,122,6,1354,24,1787065,2020-04-04,0.812362174304648,0.0377129671699367
Idaho,2020-04-11,42,1,1396,25,1787065,2020-04-05,0.694134491108651,0.0358449509878929
Idaho,2020-04-12,11,2,1407,27,1787065,2020-04-06,0.652270545507843,0.035906311783167
Idaho,2020-04-13,19,0,1426,27,1787065,2020-04-07,0.697630763948731,0.0386381944449044
Idaho,2020-04-14,38,6,1464,33,1787065,2020-04-08,0.675402134042922,0.0393234325565939
Idaho,2020-04-15,9,6,1473,39,1787065,2020-04-09,0.645755365398711,0.0397434953674156
Idaho,2020-04-16,114,2,1587,41,1787065,2020-04-10,0.93681415013223,0.0496510506550062
Idaho,2020-04-17,22,0,1609,41,1787065,2020-04-11,0.685451707870639,0.0428407317419149
Idaho,2020-04-18,46,2,1655,43,1787065,2020-04-12,0.730771161398975,0.0453205035247847
Idaho,2020-04-19,13,1,1668,44,1787065,2020-04-13,0.782717843268042,0.048356469848636
Idaho,2020-04-20,4,1,1672,45,1787065,2020-04-14,0.769949562994466,0.0489907175193237
Idaho,2020-04-21,64,3,1736,48,1787065,2020-04-15,0.88836279854082,0.0537661624675613
Idaho,2020-04-22,30,3,1766,51,1787065,2020-04-16,0.978389866426446,0.0570608557679663
Idaho,2020-04-23,70,3,1836,54,1787065,2020-04-17,0.831669201535774,0.052599378733333
Idaho,2020-04-24,34,0,1870,54,1787065,2020-04-18,0.894530222476928,0.0552642617054612
Idaho,2020-04-25,17,2,1887,56,1787065,2020-04-19,0.8153298563318,0.053414034846346
Idaho,2020-04-26,10,0,1897,56,1787065,2020-04-20,0.832193494383298,0.0548732140283353
Idaho,2020-04-27,0,0,1897,56,1787065,2020-04-21,0.847636926158149,0.0563839696114533
Idaho,2020-04-28,55,4,1952,60,1787065,2020-04-22,0.838731244166406,0.0569367868392686
Idaho,2020-04-29,0,0,1952,60,1787065,2020-04-23,0.745670920691591,0.0545288581775249
Idaho,2020-04-30,32,0,1984,60,1787065,2020-04-24,0.624461938875284,0.0511579153475843
Idaho,2020-05-01,31,3,2015,63,1787065,2020-04-25,0.661763685688606,0.0547679523139097
Idaho,2020-05-02,46,1,2061,64,1787065,2020-04-26,0.855001939531621,0.0646320714993872
Idaho,2020-05-03,0,0,2061,64,1787065,2020-04-27,0.831485471783482,0.0647310561869087
Idaho,2020-05-04,45,0,2106,64,1787065,2020-04-28,1.0853039761467,0.0748930895356154
Idaho,2020-05-05,21,1,2127,65,1787065,2020-04-29,0.895683390376946,0.0675146758371307
Idaho,2020-05-06,31,1,2158,66,1787065,2020-04-30,1.06144598424304,0.073775595819224
Idaho,2020-05-07,20,1,2178,67,1787065,2020-05-01,0.993044902754587,0.0711134225451602
Idaho,2020-05-08,0,0,2178,67,1787065,2020-05-02,0.83060657410087,0.0648594766633701
Idaho,2020-05-09,27,0,2205,67,1787065,2020-05-03,0.758619797700117,0.0629999451265534
Idaho,2020-05-10,25,0,2230,67,1787065,2020-05-04,0.938505393261723,0.0719800778476174
Illinois,2020-03-08,1,0,7,0,12671821,2020-03-02,2.0717329883191,0.926507158622058
Illinois,2020-03-09,0,0,7,0,12671821,2020-03-03,1.4332397479255,0.716619873962751
Illinois,2020-03-10,5,0,12,0,12671821,2020-03-04,3.12790962482074,1.04263654160691
Illinois,2020-03-11,13,0,25,0,12671821,2020-03-05,5.77895738856948,1.23207785503156
Illinois,2020-03-12,7,0,32,0,12671821,2020-03-06,3.87636793633988,0.732564682124284
Illinois,2020-03-13,14,0,46,0,12671821,2020-03-07,3.62708967238097,0.55967208706129
Illinois,2020-03-14,18,0,64,0,12671821,2020-03-08,3.36838385679063,0.438526226080959
Illinois,2020-03-15,2,0,66,0,12671821,2020-03-09,2.32431769116047,0.300068123638659
Illinois,2020-03-16,17,0,83,0,12671821,2020-03-10,2.33321951341554,0.265895040755711
Illinois,2020-03-17,78,1,161,1,12671821,2020-03-11,3.63335891735482,0.296662513330347
Illinois,2020-03-18,111,0,272,1,12671821,2020-03-12,4.00018145476136,0.25401177638925
Illinois,2020-03-19,150,3,422,4,12671821,2020-03-13,3.92036234938255,0.198261245866206
Illinois,2020-03-20,163,1,585,5,12671821,2020-03-14,3.399110253216,0.14627441558476
Illinois,2020-03-21,168,1,753,6,12671821,2020-03-15,2.90759332460028,0.110690186133072
Illinois,2020-03-22,296,3,1049,9,12671821,2020-03-16,2.98179778839642,0.0950562416472662
Illinois,2020-03-23,236,3,1285,12,12671821,2020-03-17,2.61531307397953,0.0754033899617864
Illinois,2020-03-24,252,4,1537,16,12671821,2020-03-18,2.24566693670497,0.0605171371241296
Illinois,2020-03-25,328,3,1865,19,12671821,2020-03-19,2.07424449167311,0.051953616819718
Illinois,2020-03-26,673,7,2538,26,12671821,2020-03-20,2.27077188054932,0.0493529456272346
Illinois,2020-03-27,486,8,3024,34,12671821,2020-03-21,2.09810472016442,0.0424748885156451
Illinois,2020-03-28,467,13,3491,47,12671821,2020-03-22,1.92181742748854,0.0367211362714788
Illinois,2020-03-29,1105,19,4596,66,12671821,2020-03-23,2.10092567619867,0.0352710901707768
Illinois,2020-03-30,460,7,5056,73,12671821,2020-03-24,1.84029195929943,0.0299640757666379
Illinois,2020-03-31,938,26,5994,99,12671821,2020-03-25,1.85089983098004,0.0277212547367842
Illinois,2020-04-01,986,42,6980,141,12671821,2020-03-26,1.82328162152357,0.0254910947035245
Illinois,2020-04-02,715,22,7695,163,12671821,2020-03-27,1.57893253773662,0.0219848195657456
Illinois,2020-04-03,1209,47,8904,210,12671821,2020-03-28,1.60987308015908,0.0209925911993055
Illinois,2020-04-04,1453,34,10357,244,12671821,2020-03-29,1.68635863535643,0.0203500938844743
Illinois,2020-04-05,902,30,11259,274,12671821,2020-03-30,1.44285491273712,0.0176748268643096
Illinois,2020-04-06,1003,33,12262,307,12671821,2020-03-31,1.42820944283152,0.0168234336284235
Illinois,2020-04-07,1291,73,13553,380,12671821,2020-04-01,1.38880975532749,0.0159728296771697
Illinois,2020-04-08,1525,82,15078,462,12671821,2020-04-02,1.38376769309976,0.015376145764094
Illinois,2020-04-09,1344,66,16422,528,12671821,2020-04-03,1.38944273974382,0.0148724762820204
Illinois,2020-04-10,1465,69,17887,597,12671821,2020-04-04,1.32996798925898,0.0140315715935955
Illinois,2020-04-11,1293,80,19180,677,12671821,2020-04-05,1.22638882989195,0.0130555579415252
Illinois,2020-04-12,1672,43,20852,720,12671821,2020-04-06,1.27765297102267,0.0130440679389995
Illinois,2020-04-13,1173,78,22025,798,12671821,2020-04-07,1.23877157778233,0.012536530079409
Illinois,2020-04-14,1223,70,23248,868,12671821,2020-04-08,1.17464366616088,0.0119291592924435
Illinois,2020-04-15,1345,81,24593,949,12671821,2020-04-09,1.11587082684663,0.0114389643610954
Illinois,2020-04-16,1141,123,25734,1072,12671821,2020-04-10,1.07021585774097,0.0110898731942642
Illinois,2020-04-17,1844,60,27578,1132,12671821,2020-04-11,1.10181369350223,0.0111918392273044
Illinois,2020-04-18,1582,127,29160,1259,12671821,2020-04-12,1.11659345111582,0.011176557288801
Illinois,2020-04-19,1197,31,30357,1290,12671821,2020-04-13,1.04059896154253,0.0106729502041229
Illinois,2020-04-20,1156,59,31513,1349,12671821,2020-04-14,1.0299977645534,0.0105736774670926
Illinois,2020-04-21,1546,119,33059,1468,12671821,2020-04-15,1.06206431615547,0.010721907289682
Illinois,2020-04-22,2048,97,35107,1565,12671821,2020-04-16,1.12684718860368,0.0109890560112096
Illinois,2020-04-23,1830,123,36937,1688,12671821,2020-04-17,1.17245348951279,0.0110766663327309
Illinois,2020-04-24,2721,107,39658,1795,12671821,2020-04-18,1.22140375464669,0.01111239853485
Illinois,2020-04-25,2119,80,41777,1875,12671821,2020-04-19,1.22108210785191,0.0108705021474354
Illinois,2020-04-26,2126,58,43903,1933,12671821,2020-04-20,1.25375201914197,0.0107718446152066
Illinois,2020-04-27,1980,50,45883,1983,12671821,2020-04-21,1.26639668552987,0.0105639483828737
Illinois,2020-04-28,2219,142,48102,2125,12671821,2020-04-22,1.25819338706656,0.0102580718318111
Illinois,2020-04-29,2256,90,50358,2215,12671821,2020-04-23,1.21281259149731,0.00982042535416853
Illinois,2020-04-30,2560,140,52918,2355,12671821,2020-04-24,1.2190036767369,0.00964249566666467
Illinois,2020-05-01,3137,102,56055,2457,12671821,2020-04-25,1.20082421065539,0.00937743352940967
Illinois,2020-05-02,2450,102,58505,2559,12671821,2020-04-26,1.17867534017648,0.00911295460488584
Illinois,2020-05-03,2994,59,61499,2618,12671821,2020-04-27,1.19860255808034,0.00903557683291835
Illinois,2020-05-04,2278,41,63777,2659,12671821,2020-04-28,1.1748565759795,0.00878251703256768
Illinois,2020-05-05,2112,175,65889,2834,12671821,2020-04-29,1.12877038530258,0.00846334502774756
Illinois,2020-05-06,2343,140,68232,2974,12671821,2020-04-30,1.10690155066336,0.00827915418422718
Illinois,2020-05-07,2639,137,70871,3111,12671821,2020-05-01,1.09092719654398,0.00814170117313389
Illinois,2020-05-08,2889,130,73760,3241,12671821,2020-05-02,1.05863154836818,0.00795581365575722
Illinois,2020-05-09,2325,108,76085,3349,12671821,2020-05-03,1.04041585991366,0.00784666618116812
Illinois,2020-05-10,1656,57,77741,3406,12671821,2020-05-04,0.955431120300992,0.00749663318154539
Indiana,2020-03-08,1,0,2,0,6732219,2020-03-02,5.15678459628379,2.97727097481736
Indiana,2020-03-09,1,0,3,0,6732219,2020-03-03,4.47623658801517,2.23811829400758
Indiana,2020-03-10,3,0,6,0,6732219,2020-03-04,5.10801537269068,1.93064833846207
Indiana,2020-03-11,5,0,11,0,6732219,2020-03-05,5.16966993558419,1.49235516446552
Indiana,2020-03-12,2,0,13,0,6732219,2020-03-06,3.40198744589755,0.909219389761055
Indiana,2020-03-13,0,0,13,0,6732219,2020-03-07,2.14079269335334,0.593749063540318
Indiana,2020-03-14,3,0,16,0,6732219,2020-03-08,2.16798514278153,0.541996285695384
Indiana,2020-03-15,4,0,20,0,6732219,2020-03-09,2.15402011989712,0.494166106578153
Indiana,2020-03-16,5,1,25,1,6732219,2020-03-10,2.15365706430837,0.44906854084414
Indiana,2020-03-17,5,1,30,2,6732219,2020-03-11,1.92830495633904,0.385660991267808
Indiana,2020-03-18,8,0,38,2,6732219,2020-03-12,1.83534077459088,0.346846804330294
Indiana,2020-03-19,22,0,60,2,6732219,2020-03-13,2.72765671027296,0.393703333983246
Indiana,2020-03-20,26,1,86,3,6732219,2020-03-14,3.18898355512821,0.370711808276524
Indiana,2020-03-21,42,1,128,4,6732219,2020-03-15,3.38546756863269,0.318477999104865
Indiana,2020-03-22,76,2,204,6,6732219,2020-03-16,3.74638563665409,0.27543975000703
Indiana,2020-03-23,66,1,270,7,6732219,2020-03-17,3.21714823770542,0.205117879883373
Indiana,2020-03-24,98,5,368,12,6732219,2020-03-18,3.03766052833469,0.164983073105144
Indiana,2020-03-25,109,2,477,14,6732219,2020-03-19,2.79602057930025,0.133295051056179
Indiana,2020-03-26,168,3,645,17,6732219,2020-03-20,2.72814798187456,0.112698754357797
Indiana,2020-03-27,334,8,979,25,6732219,2020-03-21,3.09058228820387,0.103364534223792
Indiana,2020-03-28,254,6,1233,31,6732219,2020-03-22,2.7044158319754,0.0813197259156786
Indiana,2020-03-29,280,1,1513,32,6732219,2020-03-23,2.36460288687058,0.0653314906743902
Indiana,2020-03-30,273,3,1786,35,6732219,2020-03-24,2.14356251942788,0.0550355567614205
Indiana,2020-03-31,372,14,2158,49,6732219,2020-03-25,2.05843950600361,0.0486396359150868
Indiana,2020-04-01,406,16,2564,65,6732219,2020-03-26,1.98397850570144,0.0434181900756699
Indiana,2020-04-02,474,13,3038,78,6732219,2020-03-27,1.90215626327618,0.0388762278287449
Indiana,2020-04-03,399,24,3437,102,6732219,2020-03-28,1.65624052298384,0.0333998211987686
Indiana,2020-04-04,516,14,3953,116,6732219,2020-03-29,1.61781234171023,0.0310144349564361
Indiana,2020-04-05,458,11,4411,127,6732219,2020-03-30,1.54253720404705,0.0286491367078421
Indiana,2020-04-06,545,16,4956,143,6732219,2020-03-31,1.52531741169967,0.0270870747856975
Indiana,2020-04-07,554,30,5510,173,6732219,2020-04-01,1.46484676393942,0.0252973727066384
Indiana,2020-04-08,433,30,5943,203,6732219,2020-04-02,1.35335091654319,0.0232783434369401
Indiana,2020-04-09,408,42,6351,245,6732219,2020-04-03,1.24152738168302,0.0215665188965918
Indiana,2020-04-10,556,55,6907,300,6732219,2020-04-04,1.24458783038508,0.021125074211845
Indiana,2020-04-11,528,30,7435,330,6732219,2020-04-05,1.19768115914352,0.0202938516092982
Indiana,2020-04-12,493,13,7928,343,6732219,2020-04-06,1.16643596253809,0.0196658618242659
Indiana,2020-04-13,431,7,8359,350,6732219,2020-04-07,1.09591134076101,0.0187836784634498
Indiana,2020-04-14,168,37,8527,387,6732219,2020-04-08,0.955430807797757,0.017391603403635
Indiana,2020-04-15,433,49,8960,436,6732219,2020-04-09,0.966102960513935,0.0175858674424204
Indiana,2020-04-16,582,41,9542,477,6732219,2020-04-10,1.03622120901002,0.0183409165850191
Indiana,2020-04-17,612,45,10154,522,6732219,2020-04-11,1.05076905666725,0.0184373824655966
Indiana,2020-04-18,487,23,10641,545,6732219,2020-04-12,1.02694705060686,0.0181342071310705
Indiana,2020-04-19,570,17,11211,562,6732219,2020-04-13,1.04578648369313,0.0182490999684231
Indiana,2020-04-20,477,15,11688,577,6732219,2020-04-14,1.05240527319274,0.0182373149715229
Indiana,2020-04-21,409,58,12097,635,6732219,2020-04-15,1.11708756096343,0.0186935718158905
Indiana,2020-04-22,341,31,12438,666,6732219,2020-04-16,1.06475280846767,0.0180518443371404
Indiana,2020-04-23,601,40,13039,706,6732219,2020-04-17,1.05432806734848,0.0178264910509624
Indiana,2020-04-24,642,35,13681,741,6732219,2020-04-18,1.05337779379088,0.0177345376462109
Indiana,2020-04-25,718,45,14399,786,6732219,2020-04-19,1.11149837454812,0.0181289507468137
Indiana,2020-04-26,613,27,15012,813,6732219,2020-04-20,1.10148017600917,0.0178636676031837
Indiana,2020-04-27,949,31,15961,844,6732219,2020-04-21,1.21197660014138,0.0185386017946923
Indiana,2020-04-28,627,57,16588,901,6732219,2020-04-22,1.22458206575405,0.0182712399472207
Indiana,2020-04-29,594,63,17182,964,6732219,2020-04-23,1.234749306014,0.0179250626545651
Indiana,2020-04-30,653,150,17835,1114,6732219,2020-04-24,1.19171298302473,0.0172062730894057
Indiana,2020-05-01,795,61,18630,1175,6732219,2020-04-25,1.1832045236681,0.0168173368027492
Indiana,2020-05-02,665,-60,19295,1115,6732219,2020-04-26,1.13077094803327,0.0161588180204956
Indiana,2020-05-03,638,17,19933,1132,6732219,2020-04-27,1.10795043517411,0.0157924506239267
Indiana,2020-05-04,574,19,20507,1151,6732219,2020-04-28,1.00412604054103,0.0148910647795543
Indiana,2020-05-05,526,60,21033,1211,6732219,2020-04-29,0.981430736569879,0.0147188854689346
Indiana,2020-05-06,837,166,21870,1377,6732219,2020-04-30,1.0434469128927,0.0152380797489353
Indiana,2020-05-07,633,37,22503,1414,6732219,2020-05-01,1.03384758102053,0.0151301968695171
Indiana,2020-05-08,643,33,23146,1447,6732219,2020-05-02,0.992870864616914,0.0147729667861779
Indiana,2020-05-09,586,43,23732,1490,6732219,2020-05-03,0.977048443834224,0.0146663636284447
Indiana,2020-05-10,394,18,24126,1508,6732219,2020-05-04,0.929054015388696,0.0143458653960082
Iowa,2020-03-08,0,0,0,0,3155070,2020-03-02,5,5
Iowa,2020-03-09,3,0,3,0,3155070,2020-03-03,20,10
Iowa,2020-03-10,5,0,8,0,3155070,2020-03-04,11.982103446788,3.99403448226267
Iowa,2020-03-11,5,0,13,0,3155070,2020-03-05,6.18427203251513,1.65281622373427
Iowa,2020-03-12,1,0,14,0,3155070,2020-03-06,3.29162027887547,0.849892701474886
Iowa,2020-03-13,3,0,17,0,3155070,2020-03-07,2.70400459889788,0.6373399960801
Iowa,2020-03-14,0,0,17,0,3155070,2020-03-08,2.0589327504241,0.485295103277316
Iowa,2020-03-15,1,0,18,0,3155070,2020-03-09,1.81264906618958,0.415850215769671
Iowa,2020-03-16,5,0,23,0,3155070,2020-03-10,1.75830821673455,0.383694309440424
Iowa,2020-03-17,0,0,23,0,3155070,2020-03-11,1.184793902349,0.296198475587249
Iowa,2020-03-18,15,0,38,0,3155070,2020-03-12,1.87010904438434,0.36675855807162
Iowa,2020-03-19,6,0,44,0,3155070,2020-03-13,1.96949149577651,0.353731114938105
Iowa,2020-03-20,1,0,45,0,3155070,2020-03-14,1.54407962550223,0.286728388229932
Iowa,2020-03-21,24,0,69,0,3155070,2020-03-15,2.54313460319434,0.3493264032922
Iowa,2020-03-22,21,0,90,0,3155070,2020-03-16,2.74555413120685,0.321342805205525
Iowa,2020-03-23,15,0,105,0,3155070,2020-03-17,2.29931796617845,0.252382935038577
Iowa,2020-03-24,19,0,124,0,3155070,2020-03-18,2.2250797239923,0.220315722163819
Iowa,2020-03-25,22,1,146,1,3155070,2020-03-19,1.91697079770486,0.183612501804307
Iowa,2020-03-26,33,0,179,1,3155070,2020-03-20,2.01687296700271,0.172945430126569
Iowa,2020-03-27,56,2,235,3,3155070,2020-03-21,2.37266502414842,0.171680015833933
Iowa,2020-03-28,63,0,298,3,3155070,2020-03-22,2.25358757189616,0.148597163999575
Iowa,2020-03-29,38,1,336,4,3155070,2020-03-23,1.92398807981995,0.122420429933646
Iowa,2020-03-30,88,2,424,6,3155070,2020-03-24,2.09583435903273,0.117160702409422
Iowa,2020-03-31,73,1,497,7,3155070,2020-03-25,2.02402170119745,0.104659670597198
Iowa,2020-04-01,50,2,547,9,3155070,2020-03-26,1.80114252306495,0.0898328241208875
Iowa,2020-04-02,67,2,614,11,3155070,2020-03-27,1.68079021168979,0.0804952522349453
Iowa,2020-04-03,85,0,699,11,3155070,2020-03-28,1.58238467504948,0.0733813321875258
Iowa,2020-04-04,88,3,787,14,3155070,2020-03-29,1.49786738136996,0.0676667508285878
Iowa,2020-04-05,82,4,869,18,3155070,2020-03-30,1.48952255206285,0.0644579448458642
Iowa,2020-04-06,77,7,946,25,3155070,2020-03-31,1.33472159689901,0.0583633004534985
Iowa,2020-04-07,100,0,1046,25,3155070,2020-04-01,1.31640018097643,0.0561314923189662
Iowa,2020-04-08,99,2,1145,27,3155070,2020-04-02,1.35665667644153,0.0554314890610158
Iowa,2020-04-09,125,2,1270,29,3155070,2020-04-03,1.39495200181359,0.0544222608586005
Iowa,2020-04-10,118,2,1388,31,3155070,2020-04-04,1.3608643800728,0.0518072215456178
Iowa,2020-04-11,122,3,1510,34,3155070,2020-04-05,1.33236948088306,0.0495171217889377
Iowa,2020-04-12,77,7,1587,41,3155070,2020-04-06,1.24304256401502,0.0463576652099489
Iowa,2020-04-13,123,0,1710,41,3155070,2020-04-07,1.26263848107623,0.0456507906265532
Iowa,2020-04-14,189,8,1899,49,3155070,2020-04-08,1.34540017487858,0.046038646205699
Iowa,2020-04-15,96,4,1995,53,3155070,2020-04-09,1.25792788898925,0.0431212126714056
Iowa,2020-04-16,146,7,2141,60,3155070,2020-04-10,1.22364437566239,0.0414378272828094
Iowa,2020-04-17,191,4,2332,64,3155070,2020-04-11,1.27295999576315,0.0414093917575273
Iowa,2020-04-18,181,10,2513,74,3155070,2020-04-12,1.28693110551029,0.0406151855485283
Iowa,2020-04-19,389,1,2902,75,3155070,2020-04-13,1.59654722223743,0.0440102488135864
Iowa,2020-04-20,257,4,3159,79,3155070,2020-04-14,1.58007099170219,0.0414946971171076
Iowa,2020-04-21,482,4,3641,83,3155070,2020-04-15,1.69097236512774,0.0405030582529311
Iowa,2020-04-22,107,7,3748,90,3155070,2020-04-16,1.49654939571687,0.0357335580184063
Iowa,2020-04-23,176,6,3924,96,3155070,2020-04-17,1.37692319175224,0.0325996013963738
Iowa,2020-04-24,521,11,4445,107,3155070,2020-04-18,1.52074260482095,0.0330752565678362
Iowa,2020-04-25,647,5,5092,112,3155070,2020-04-19,1.69181547270724,0.0333075845920016
Iowa,2020-04-26,384,6,5476,118,3155070,2020-04-20,1.48517345941257,0.0292676978542351
Iowa,2020-04-27,392,9,5868,127,3155070,2020-04-21,1.41613064999171,0.0272031174809277
Iowa,2020-04-28,508,9,6376,136,3155070,2020-04-22,1.3243682481155,0.0253192427963574
Iowa,2020-04-29,467,12,6843,148,3155070,2020-04-23,1.41001208283636,0.0253409188571002
Iowa,2020-04-30,302,14,7145,162,3155070,2020-04-24,1.36398236345227,0.0240295693065437
Iowa,2020-05-01,739,8,7884,170,3155070,2020-04-25,1.35677645312432,0.0231328465239403
Iowa,2020-05-02,759,5,8643,175,3155070,2020-04-26,1.31081685486897,0.0219940667355478
Iowa,2020-05-03,532,9,9175,184,3155070,2020-04-27,1.28689725769442,0.0211564605931004
Iowa,2020-05-04,528,4,9703,188,3155070,2020-04-28,1.26485681071193,0.0204221783360303
Iowa,2020-05-05,408,19,10111,207,3155070,2020-04-29,1.1723741398203,0.019180626850854
Iowa,2020-05-06,293,12,10404,219,3155070,2020-04-30,1.08157527586918,0.0181221530310415
Iowa,2020-05-07,655,12,11059,231,3155070,2020-05-01,1.17325745311197,0.0187511297320467
Iowa,2020-05-08,398,12,11457,243,3155070,2020-05-02,1.04193404249769,0.0174286180993098
Iowa,2020-05-09,214,9,11671,252,3155070,2020-05-03,0.873729464729424,0.0158754975386129
Iowa,2020-05-10,288,13,11959,265,3155070,2020-05-04,0.826354363520748,0.0156586286559813
Kansas,2020-03-08,1,0,1,0,2913314,2020-03-02,10,7.07106781186548
Kansas,2020-03-09,0,0,1,0,2913314,2020-03-03,5.21231403354432,3.68566259879299
Kansas,2020-03-10,0,0,1,0,2913314,2020-03-04,3.43785639752253,2.43093157143374
Kansas,2020-03-11,0,0,1,0,2913314,2020-03-05,2.81729392244855,1.99212763715902
Kansas,2020-03-12,3,0,4,0,2913314,2020-03-06,6.21171526831308,2.77796351936428
Kansas,2020-03-13,2,1,6,1,2913314,2020-03-07,4.89656900841051,1.85072912481719
Kansas,2020-03-14,2,0,8,1,2913314,2020-03-08,3.67453486926271,1.2248449564209
Kansas,2020-03-15,0,0,8,1,2913314,2020-03-09,2.19547371086538,0.77621717443485
Kansas,2020-03-16,3,0,11,1,2913314,2020-03-10,2.48006568350352,0.747767938874316
Kansas,2020-03-17,7,0,18,1,2913314,2020-03-11,3.28102315029443,0.773344572934414
Kansas,2020-03-18,4,0,22,1,2913314,2020-03-12,2.82965917975609,0.603285364166228
Kansas,2020-03-19,13,0,35,1,2913314,2020-03-13,3.01622054115211,0.533197499550704
Kansas,2020-03-20,13,0,48,1,2913314,2020-03-14,2.92776118348516,0.446479394756782
Kansas,2020-03-21,9,1,57,2,2913314,2020-03-15,2.46262092765248,0.348267191486994
Kansas,2020-03-22,8,0,65,2,2913314,2020-03-16,2.20562954861835,0.289613348239076
Kansas,2020-03-23,19,0,84,2,2913314,2020-03-17,2.27697614214491,0.264693100000357
Kansas,2020-03-24,16,0,100,2,2913314,2020-03-18,2.04973214863602,0.224987332472111
Kansas,2020-03-25,34,1,134,3,2913314,2020-03-19,2.30431969069005,0.216772162045936
Kansas,2020-03-26,38,0,172,3,2913314,2020-03-20,2.25168817424263,0.191676426355628
Kansas,2020-03-27,34,1,206,4,2913314,2020-03-21,2.07002325800315,0.164163522723284
Kansas,2020-03-28,60,0,266,4,2913314,2020-03-22,2.24926321806056,0.155213908067914
Kansas,2020-03-29,64,3,330,7,2913314,2020-03-23,2.29195382512933,0.140528705446984
Kansas,2020-03-30,42,1,372,8,2913314,2020-03-24,1.97631866833542,0.116254039313848
Kansas,2020-03-31,62,1,434,9,2913314,2020-03-25,1.90659026502049,0.104168153936508
Kansas,2020-04-01,51,1,485,10,2913314,2020-03-26,1.70208297527021,0.0907213274060746
Kansas,2020-04-02,68,2,553,12,2913314,2020-03-27,1.61896661928864,0.0828335382788769
Kansas,2020-04-03,76,6,629,18,2913314,2020-03-28,1.60621191976787,0.0780045464810127
Kansas,2020-04-04,69,3,698,21,2913314,2020-03-29,1.46897161128532,0.0705942704981391
Kansas,2020-04-05,53,1,751,22,2913314,2020-03-30,1.31004456681393,0.0637719717185298
Kansas,2020-04-06,98,3,849,25,2913314,2020-03-31,1.40173279794494,0.0641137658577099
Kansas,2020-04-07,63,4,912,29,2913314,2020-04-01,1.31125626875244,0.0599128281568368
Kansas,2020-04-08,134,5,1046,34,2913314,2020-04-02,1.44820463738908,0.0610888255875338
Kansas,2020-04-09,70,8,1116,42,2913314,2020-04-03,1.34263533281751,0.0565351462412027
Kansas,2020-04-10,1,0,1117,42,2913314,2020-04-04,1.08663946733754,0.0491395353093663
Kansas,2020-04-11,158,13,1275,55,2913314,2020-04-05,1.26256053627276,0.0525155951092347
Kansas,2020-04-12,69,1,1344,56,2913314,2020-04-06,1.24793327466674,0.0512033224738168
Kansas,2020-04-13,46,6,1390,62,2913314,2020-04-07,1.08352108356911,0.0465412156851497
Kansas,2020-04-14,51,7,1441,69,2913314,2020-04-08,1.04160792671396,0.0452445571206532
Kansas,2020-04-15,63,2,1504,71,2913314,2020-04-09,0.899927936745739,0.0420050388961826
Kansas,2020-04-16,111,9,1615,80,2913314,2020-04-10,1.00239887331731,0.0448286404261339
Kansas,2020-04-17,115,2,1730,82,2913314,2020-04-11,1.24159153048843,0.0501065563041299
Kansas,2020-04-18,91,3,1821,85,2913314,2020-04-12,1.0587843635961,0.0452703503704252
Kansas,2020-04-19,84,8,1905,93,2913314,2020-04-13,1.06577298678814,0.0449569200546025
Kansas,2020-04-20,143,9,2048,102,2913314,2020-04-14,1.23930108555313,0.0482763161607568
Kansas,2020-04-21,116,7,2164,109,2913314,2020-04-15,1.30425476993292,0.048472246785304
Kansas,2020-04-22,167,3,2331,112,2913314,2020-04-16,1.40222315739814,0.0487306233403557
Kansas,2020-04-23,390,1,2721,113,2913314,2020-04-17,1.73429337485225,0.0521253224569725
Kansas,2020-04-24,238,5,2959,118,2913314,2020-04-18,1.68385439290085,0.0480122411262021
Kansas,2020-04-25,176,2,3135,120,2913314,2020-04-19,1.57066672621466,0.0433132893913579
Kansas,2020-04-26,142,1,3277,121,2913314,2020-04-20,1.46825441041381,0.039624705316874
Kansas,2020-04-27,196,5,3473,126,2913314,2020-04-21,1.3947798502842,0.036935663244701
Kansas,2020-04-28,179,1,3652,127,2913314,2020-04-22,1.35274884708287,0.0350566024443173
Kansas,2020-04-29,187,7,3839,134,2913314,2020-04-23,1.2843432325808,0.0330625603265283
Kansas,2020-04-30,574,0,4413,134,2913314,2020-04-24,1.36638196891761,0.0332080705697374
Kansas,2020-05-01,221,6,4634,140,2913314,2020-04-25,1.26685057272529,0.0309448502200261
Kansas,2020-05-02,251,2,4885,142,2913314,2020-04-26,1.25472209899405,0.0299850290620043
Kansas,2020-05-03,271,2,5156,144,2913314,2020-04-27,1.2867851181508,0.0296774857380312
Kansas,2020-05-04,227,12,5383,156,2913314,2020-04-28,1.24057585665954,0.0283787316545796
Kansas,2020-05-05,265,5,5648,161,2913314,2020-04-29,1.23725324972909,0.0276865964578119
Kansas,2020-05-06,345,3,5993,164,2913314,2020-04-30,1.27798079857697,0.0275296500907896
Kansas,2020-05-07,339,1,6332,165,2913314,2020-05-01,1.08121074060442,0.0246751463352462
Kansas,2020-05-08,335,3,6667,168,2913314,2020-05-02,1.12402786517889,0.0249230737976165
Kansas,2020-05-09,162,6,6829,174,2913314,2020-05-03,1.0568519837817,0.023963727040844
Kansas,2020-05-10,122,0,6951,174,2913314,2020-05-04,0.965261760639647,0.0227767594715076
Kentucky,2020-03-08,0,0,1,0,4467673,2020-03-02,3.43785639752253,2.43093157143374
Kentucky,2020-03-09,3,0,4,0,4467673,2020-03-03,7.04323480612137,3.14983036159599
Kentucky,2020-03-10,1,0,5,0,4467673,2020-03-04,4.42461282551111,1.80634062197939
Kentucky,2020-03-11,3,0,8,0,4467673,2020-03-05,4.07713477802727,1.35904492600909
Kentucky,2020-03-12,2,0,10,0,4467673,2020-03-06,3.23607093182559,0.97571209780375
Kentucky,2020-03-13,4,0,14,0,4467673,2020-03-07,2.90419786803683,0.776179528970938
Kentucky,2020-03-14,2,0,16,0,4467673,2020-03-08,2.45942344715707,0.614855861789269
Kentucky,2020-03-15,2,0,18,0,4467673,2020-03-09,2.1720106760263,0.511947825942592
Kentucky,2020-03-16,3,1,21,1,4467673,2020-03-10,1.78765940663887,0.421355362962089
Kentucky,2020-03-17,5,0,26,1,4467673,2020-03-11,1.91162301516826,0.407559396235745
Kentucky,2020-03-18,2,0,28,1,4467673,2020-03-12,1.57734321305068,0.344204508129981
Kentucky,2020-03-19,22,1,50,2,4467673,2020-03-13,2.77768938597523,0.433802200765804
Kentucky,2020-03-20,14,0,64,2,4467673,2020-03-14,2.62628065739321,0.36775284996157
Kentucky,2020-03-21,23,1,87,3,4467673,2020-03-15,2.7680939053093,0.326222995234226
Kentucky,2020-03-22,16,0,103,3,4467673,2020-03-16,2.45349647799188,0.264567329266733
Kentucky,2020-03-23,20,1,123,4,4467673,2020-03-17,2.26446567256044,0.22312443265718
Kentucky,2020-03-24,39,0,162,4,4467673,2020-03-18,2.40695829045655,0.20564032472564
Kentucky,2020-03-25,35,1,197,5,4467673,2020-03-19,2.34261044728123,0.179670019557279
Kentucky,2020-03-26,50,0,247,5,4467673,2020-03-20,2.14704641425855,0.152583944522889
Kentucky,2020-03-27,54,2,301,7,4467673,2020-03-21,2.09541506425335,0.135825584703632
Kentucky,2020-03-28,79,2,380,9,4467673,2020-03-22,2.12784845695069,0.124098642130898
Kentucky,2020-03-29,58,0,438,9,4467673,2020-03-23,1.98804697934269,0.10845685438055
Kentucky,2020-03-30,41,2,479,11,4467673,2020-03-24,1.76056559596102,0.0931790123410031
Kentucky,2020-03-31,149,0,628,11,4467673,2020-03-25,1.99781614437538,0.0924479058902026
Kentucky,2020-04-01,4,7,632,18,4467673,2020-03-26,1.56792119054305,0.0750898064728686
Kentucky,2020-04-02,138,13,770,31,4467673,2020-03-27,1.6772314459981,0.0732701959164
Kentucky,2020-04-03,0,3,770,34,4467673,2020-03-28,1.3392567323254,0.0617753065566482
Kentucky,2020-04-04,147,6,917,40,4467673,2020-03-29,1.42901743685988,0.0616093164340235
Kentucky,2020-04-05,38,5,955,45,4467673,2020-03-30,1.28198332147673,0.0563271133637512
Kentucky,2020-04-06,0,0,955,45,4467673,2020-03-31,1.11694522482078,0.0511414086603923
Kentucky,2020-04-07,194,20,1149,65,4467673,2020-04-01,1.19941300128267,0.0524968809080004
Kentucky,2020-04-08,0,0,1149,65,4467673,2020-04-02,1.15553914277398,0.0507714751049225
Kentucky,2020-04-09,192,8,1341,73,4467673,2020-04-03,1.23879119106177,0.0517964617796285
Kentucky,2020-04-10,352,17,1693,90,4467673,2020-04-04,1.91949340312664,0.0631466969025635
Kentucky,2020-04-11,0,0,1693,90,4467673,2020-04-05,1.37621193112205,0.0493713280160438
Kentucky,2020-04-12,270,7,1963,97,4467673,2020-04-06,1.6257582149785,0.0511811893790463
Kentucky,2020-04-13,55,16,2018,113,4467673,2020-04-07,1.54282120012782,0.0472982185794886
Kentucky,2020-04-14,30,-7,2048,106,4467673,2020-04-08,1.17091628721349,0.0390305429071162
Kentucky,2020-04-15,162,9,2210,115,4467673,2020-04-09,1.33120442351434,0.0408491001173757
Kentucky,2020-04-16,225,14,2435,129,4467673,2020-04-10,1.30463254086178,0.0394258574340092
Kentucky,2020-04-17,87,8,2522,137,4467673,2020-04-11,0.931412157136026,0.0323297879440458
Kentucky,2020-04-18,185,7,2707,144,4467673,2020-04-12,1.1509976930386,0.0361277930125932
Kentucky,2020-04-19,253,2,2960,146,4467673,2020-04-13,1.11721531873993,0.0353648329735865
Kentucky,2020-04-20,90,8,3050,154,4467673,2020-04-14,1.12700635096724,0.0350651905002867
Kentucky,2020-04-21,154,17,3204,171,4467673,2020-04-15,1.23439390405483,0.0362900100823699
Kentucky,2020-04-22,174,14,3378,185,4467673,2020-04-16,1.19469162967895,0.0349420648453786
Kentucky,2020-04-23,101,6,3479,191,4467673,2020-04-17,1.0254518882098,0.0317217504213181
Kentucky,2020-04-24,300,9,3779,200,4467673,2020-04-18,1.22670433623107,0.0345859396949851
Kentucky,2020-04-25,136,5,3915,205,4467673,2020-04-19,1.13812747185741,0.0327323929295644
Kentucky,2020-04-26,170,3,4085,208,4467673,2020-04-20,1.02637573922552,0.03058702109953
Kentucky,2020-04-27,71,5,4156,213,4467673,2020-04-21,1.00483942758036,0.0302011066521938
Kentucky,2020-04-28,219,12,4375,225,4467673,2020-04-22,1.06741543781716,0.0311795378568141
Kentucky,2020-04-29,162,9,4537,234,4467673,2020-04-23,1.04634274405167,0.030721680792482
Kentucky,2020-04-30,171,6,4708,240,4467673,2020-04-24,1.09858963972593,0.0313244131461991
Kentucky,2020-05-01,174,6,4882,246,4467673,2020-04-25,0.969076946296829,0.029165788721424
Kentucky,2020-05-02,-3,2,4879,248,4467673,2020-04-26,0.852476406041801,0.0273996294324406
Kentucky,2020-05-03,251,5,5130,253,4467673,2020-04-27,0.95440693171647,0.0294676729259793
Kentucky,2020-05-04,115,8,5245,261,4467673,2020-04-28,1.0107967041793,0.0305741038366793
Kentucky,2020-05-05,577,14,5822,275,4467673,2020-04-29,1.33817932477787,0.03513019895881
Kentucky,2020-05-06,112,8,5934,283,4467673,2020-04-30,1.21442006202257,0.0324451559107368
Kentucky,2020-05-07,195,11,6129,294,4467673,2020-05-01,1.17112577180817,0.0310238795790539
Kentucky,2020-05-08,159,4,6288,298,4467673,2020-05-02,1.12087409298944,0.0298502020418564
Kentucky,2020-05-09,152,6,6440,304,4467673,2020-05-03,1.21268012598995,0.0306835599331873
Kentucky,2020-05-10,0,0,6440,304,4467673,2020-05-04,0.979823374767347,0.0270611625487536
Louisiana,2020-03-08,0,0,0,0,4648794,2020-03-02,5,5
Louisiana,2020-03-09,0,0,0,0,4648794,2020-03-03,5,5
Louisiana,2020-03-10,0,0,0,0,4648794,2020-03-04,5,5
Louisiana,2020-03-11,5,0,5,0,4648794,2020-03-05,30,12.2474487139159
Louisiana,2020-03-12,14,0,19,0,4648794,2020-03-06,17.8805524055782,3.99821306541203
Louisiana,2020-03-13,10,0,29,0,4648794,2020-03-07,6.40932018528812,1.17017641458516
Louisiana,2020-03-14,48,1,77,1,4648794,2020-03-08,7.85404931163574,0.889295966060432
Louisiana,2020-03-15,10,1,87,2,4648794,2020-03-09,3.82629152813313,0.407884047391693
Louisiana,2020-03-16,28,1,115,3,4648794,2020-03-10,3.10810754830974,0.288580541137012
Louisiana,2020-03-17,81,1,196,4,4648794,2020-03-11,3.72631314253045,0.265488818736471
Louisiana,2020-03-18,61,2,257,6,4648794,2020-03-12,3.12661252274332,0.196568445143135
Louisiana,2020-03-19,135,4,392,10,4648794,2020-03-13,3.20374877179234,0.165661905173048
Louisiana,2020-03-20,145,4,537,14,4648794,2020-03-14,3.03386544316182,0.134473721530791
Louisiana,2020-03-21,226,6,763,20,4648794,2020-03-15,2.8960134765692,0.110489805733337
Louisiana,2020-03-22,74,0,837,20,4648794,2020-03-16,2.28885994752463,0.0835216857061626
Louisiana,2020-03-23,335,15,1172,35,4648794,2020-03-17,2.54001752803743,0.0780897225394766
Louisiana,2020-03-24,216,11,1388,46,4648794,2020-03-18,2.2081822297989,0.063931469753253
Louisiana,2020-03-25,407,19,1795,65,4648794,2020-03-19,2.27613772599041,0.0580202007553956
Louisiana,2020-03-26,509,18,2304,83,4648794,2020-03-20,2.26354140758315,0.051752455256869
Louisiana,2020-03-27,440,36,2744,119,4648794,2020-03-21,2.08254149302243,0.0443194261627855
Louisiana,2020-03-28,571,18,3315,137,4648794,2020-03-22,1.97356846603067,0.0390595099221517
Louisiana,2020-03-29,225,14,3540,151,4648794,2020-03-23,1.75060334983451,0.0336654490352791
Louisiana,2020-03-30,485,34,4025,185,4648794,2020-03-24,1.60471928226371,0.0300380742675094
Louisiana,2020-03-31,1212,54,5237,239,4648794,2020-03-25,1.93702868309975,0.0312180438963525
Louisiana,2020-04-01,1187,34,6424,273,4648794,2020-03-26,1.98037389762022,0.0291042691470943
Louisiana,2020-04-02,2725,37,9149,310,4648794,2020-03-27,2.43940187151507,0.0294825405999312
Louisiana,2020-04-03,1148,60,10297,370,4648794,2020-03-28,2.09998948266068,0.024161763520622
Louisiana,2020-04-04,2199,39,12496,409,4648794,2020-03-29,2.06684991584362,0.0215695108968472
Louisiana,2020-04-05,514,68,13010,477,4648794,2020-03-30,1.76053031419952,0.0180902925088337
Louisiana,2020-04-06,1857,35,14867,512,4648794,2020-03-31,1.7415288926455,0.0167246082981365
Louisiana,2020-04-07,1417,70,16284,582,4648794,2020-04-01,1.5537001717607,0.0147817339373354
Louisiana,2020-04-08,746,70,17030,652,4648794,2020-04-02,1.34203665390907,0.0130307104041126
Louisiana,2020-04-09,1253,50,18283,702,4648794,2020-04-03,1.08475052408099,0.0113494703019605
Louisiana,2020-04-10,970,53,19253,755,4648794,2020-04-04,1.05041398202767,0.0110988813039161
Louisiana,2020-04-11,761,51,20014,806,4648794,2020-04-05,0.882968096341014,0.0101827473739884
Louisiana,2020-04-12,581,34,20595,840,4648794,2020-04-06,0.915778896098382,0.0105143931490504
Louisiana,2020-04-13,421,44,21016,884,4648794,2020-04-07,0.763156527415975,0.00973141660605418
Louisiana,2020-04-14,502,129,21518,1013,4648794,2020-04-08,0.68238021630101,0.00943122452828705
Louisiana,2020-04-15,433,90,21951,1103,4648794,2020-04-09,0.689816477349517,0.0098324729268249
Louisiana,2020-04-16,581,53,22532,1156,4648794,2020-04-10,0.638872805033239,0.00979986147574412
Louisiana,2020-04-17,586,57,23118,1213,4648794,2020-04-11,0.626715431159556,0.0100795110036557
Louisiana,2020-04-18,462,54,23580,1267,4648794,2020-04-12,0.625929793466908,0.0104803085590816
Louisiana,2020-04-19,348,29,23928,1296,4648794,2020-04-13,0.632011108648321,0.0109456590000911
Louisiana,2020-04-20,595,32,24523,1328,4648794,2020-04-14,0.716383797049804,0.0120952809935704
Louisiana,2020-04-21,331,77,24854,1405,4648794,2020-04-15,0.721117523940556,0.0124832579920925
Louisiana,2020-04-22,404,68,25258,1473,4648794,2020-04-16,0.751956742494444,0.0130740489720837
Louisiana,2020-04-23,481,126,25739,1599,4648794,2020-04-17,0.764101612562678,0.0134906829666999
Louisiana,2020-04-24,401,61,26140,1660,4648794,2020-04-18,0.751859902755238,0.0136747013599758
Louisiana,2020-04-25,372,47,26512,1707,4648794,2020-04-19,0.763950024422641,0.0141061636403233
Louisiana,2020-04-26,261,22,26773,1729,4648794,2020-04-20,0.77557485444597,0.0145380538151144
Louisiana,2020-04-27,295,11,27068,1740,4648794,2020-04-21,0.723784407130165,0.0143443219112574
Louisiana,2020-04-28,218,61,27286,1801,4648794,2020-04-22,0.728661461495026,0.0147725254234051
Louisiana,2020-04-29,374,44,27660,1845,4648794,2020-04-23,0.759940257792108,0.0155025294999242
Louisiana,2020-04-30,341,60,28001,1905,4648794,2020-04-24,0.749891843508781,0.0157636343634122
Louisiana,2020-05-01,710,65,28711,1970,4648794,2020-04-25,0.893199227584011,0.0176121695096149
Louisiana,2020-05-02,429,23,29140,1993,4648794,2020-04-26,0.932351286626927,0.0181837847342949
Louisiana,2020-05-03,200,19,29340,2012,4648794,2020-04-27,0.916535903837435,0.0180863933880642
Louisiana,2020-05-04,333,52,29673,2064,4648794,2020-04-28,0.940837319165423,0.0184300846549669
Louisiana,2020-05-05,323,51,29996,2115,4648794,2020-04-29,0.988228388392473,0.0189798408617832
Louisiana,2020-05-06,403,52,30399,2167,4648794,2020-04-30,0.998957501544354,0.0190841020882627
Louisiana,2020-05-07,253,41,30652,2208,4648794,2020-05-01,0.963980852922868,0.0187189570554439
Louisiana,2020-05-08,203,19,30855,2227,4648794,2020-05-02,0.783227255452141,0.0169111890200356
Louisiana,2020-05-09,562,40,31417,2267,4648794,2020-05-03,0.866619368233183,0.018157310949359
Louisiana,2020-05-10,183,19,31600,2286,4648794,2020-05-04,0.889936685473035,0.0187158186640761
Maine,2020-03-08,0,0,0,0,1344212,2020-03-02,5,5
Maine,2020-03-09,0,0,0,0,1344212,2020-03-03,5,5
Maine,2020-03-10,0,0,0,0,1344212,2020-03-04,5,5
Maine,2020-03-11,0,0,0,0,1344212,2020-03-05,5,5
Maine,2020-03-12,1,0,1,0,1344212,2020-03-06,10,7.07106781186548
Maine,2020-03-13,2,0,3,0,1344212,2020-03-07,10.4246280670886,5.21231403354432
Maine,2020-03-14,0,0,3,0,1344212,2020-03-08,4.21420227245942,2.10710113622971
Maine,2020-03-15,-1,0,2,0,1344212,2020-03-09,2.71477830847369,1.35738915423685
Maine,2020-03-16,15,0,17,0,1344212,2020-03-10,10.4124833493742,2.38878750901169
Maine,2020-03-17,9,0,26,0,1344212,2020-03-11,5.78044880597132,1.09240214335288
Maine,2020-03-18,9,0,35,0,1344212,2020-03-12,3.82498697725336,0.628823985516632
Maine,2020-03-19,17,0,52,0,1344212,2020-03-13,3.48818901743122,0.479139610593976
Maine,2020-03-20,4,0,56,0,1344212,2020-03-14,2.43087288370697,0.327778832772172
Maine,2020-03-21,14,0,70,0,1344212,2020-03-15,2.34858072070964,0.282735893603421
Maine,2020-03-22,19,0,89,0,1344212,2020-03-16,2.38652946485597,0.254404895755532
Maine,2020-03-23,18,0,107,0,1344212,2020-03-17,1.94158020140608,0.203532908441349
Maine,2020-03-24,11,0,118,0,1344212,2020-03-18,1.66335604031976,0.172481986494967
Maine,2020-03-25,24,0,142,0,1344212,2020-03-19,1.7147215655683,0.164999159577686
Maine,2020-03-26,13,0,155,0,1344212,2020-03-20,1.45962059706216,0.14312757513196
Maine,2020-03-27,13,1,168,1,1344212,2020-03-21,1.45274167343203,0.136662440856802
Maine,2020-03-28,43,0,211,1,1344212,2020-03-22,1.69047860902137,0.141861813529005
Maine,2020-03-29,42,2,253,3,1344212,2020-03-23,1.74054292857069,0.135501083216009
Maine,2020-03-30,22,0,275,3,1344212,2020-03-24,1.55182442660079,0.119371109738522
Maine,2020-03-31,28,2,303,5,1344212,2020-03-25,1.53469784540267,0.112529505728894
Maine,2020-04-01,0,0,303,5,1344212,2020-03-26,1.21377505038358,0.0953631743290306
Maine,2020-04-02,73,2,376,7,1344212,2020-03-27,1.59233743630274,0.106870691231856
Maine,2020-04-03,56,2,432,9,1344212,2020-03-28,1.72757080563537,0.10612383098867
Maine,2020-04-04,24,1,456,10,1344212,2020-03-29,1.39646085187352,0.0890350919859145
Maine,2020-04-05,14,0,470,10,1344212,2020-03-30,1.13869243976788,0.0771219834550378
Maine,2020-04-06,29,0,499,10,1344212,2020-03-31,1.14841990517779,0.0765613270118526
Maine,2020-04-07,20,2,519,12,1344212,2020-04-01,1.08750589848958,0.0738247107871702
Maine,2020-04-08,18,2,537,14,1344212,2020-04-02,1.16205744496483,0.0758042693851315
Maine,2020-04-09,23,2,560,16,1344212,2020-04-03,0.892206047230265,0.065596293184421
Maine,2020-04-10,26,1,586,17,1344212,2020-04-04,0.761552464830832,0.0611693659725464
Maine,2020-04-11,30,2,616,19,1344212,2020-04-05,0.838482346718148,0.0660816662896354
Maine,2020-04-12,17,0,633,19,1344212,2020-04-06,0.892061146600951,0.0696582725496669
Maine,2020-04-13,65,0,698,19,1344212,2020-04-07,1.11437356522499,0.0787981104745619
Maine,2020-04-14,37,1,735,20,1344212,2020-04-08,1.18610013488348,0.0805177236684527
Maine,2020-04-15,35,4,770,24,1344212,2020-04-09,1.22695675044052,0.0802086719593666
Maine,2020-04-16,26,3,796,27,1344212,2020-04-10,1.18590416660021,0.0770327535236926
Maine,2020-04-17,31,2,827,29,1344212,2020-04-11,1.1646323862137,0.0748654052619251
Maine,2020-04-18,20,3,847,32,1344212,2020-04-12,1.08169816356122,0.0710169636440683
Maine,2020-04-19,20,2,867,34,1344212,2020-04-13,1.07823836670724,0.0703365156046421
Maine,2020-04-20,8,1,875,35,1344212,2020-04-14,0.807160079409016,0.0604992057609473
Maine,2020-04-21,13,1,888,36,1344212,2020-04-15,0.724637011901944,0.0583929144773319
Maine,2020-04-22,19,3,907,39,1344212,2020-04-16,0.694237612891879,0.0590974301872576
Maine,2020-04-23,30,5,937,44,1344212,2020-04-17,0.766024736159294,0.0642833678579019
Maine,2020-04-24,28,3,965,47,1344212,2020-04-18,0.790906631465884,0.0670838249219839
Maine,2020-04-25,0,0,965,47,1344212,2020-04-19,0.706077746049915,0.0647260408589024
Maine,2020-04-26,50,3,1015,50,1344212,2020-04-20,0.936730987258003,0.0767399925701071
Maine,2020-04-27,8,1,1023,51,1344212,2020-04-21,0.954454861122185,0.0781919888925862
Maine,2020-04-28,17,0,1040,51,1344212,2020-04-22,0.981381305047049,0.0793399760728527
Maine,2020-04-29,16,1,1056,52,1344212,2020-04-23,0.963441181757481,0.0786646430829951
Maine,2020-04-30,39,1,1095,53,1344212,2020-04-24,1.02602574733308,0.0813691345910146
Maine,2020-05-01,28,2,1123,55,1344212,2020-04-25,1.02142854528147,0.0810045527533249
Maine,2020-05-02,30,1,1153,56,1344212,2020-04-26,1.20626933303315,0.0877431829702903
Maine,2020-05-03,32,1,1185,57,1344212,2020-04-27,1.05099176044779,0.0803713486716809
Maine,2020-05-04,20,0,1205,57,1344212,2020-04-28,1.10472160243979,0.0816633707006516
Maine,2020-05-05,21,4,1226,61,1344212,2020-04-29,1.1108279533656,0.0812317850245845
Maine,2020-05-06,28,1,1254,62,1344212,2020-04-30,1.15604135877033,0.0819495991444587
Maine,2020-05-07,76,0,1330,62,1344212,2020-05-01,1.33132849349018,0.0866621033626137
Maine,2020-05-08,44,1,1374,63,1344212,2020-05-02,1.33627748572347,0.0841775692809279
Maine,2020-05-09,34,1,1408,64,1344212,2020-05-03,1.26699753310017,0.0791873458187608
Maine,2020-05-10,28,0,1436,64,1344212,2020-05-04,1.18222041729062,0.0744728861669994
Maryland,2020-03-08,2,0,5,0,6045680,2020-03-02,4.46005928794971,1.82081157967294
Maryland,2020-03-09,0,0,5,0,6045680,2020-03-03,2.86107109134408,1.1680273819368
Maryland,2020-03-10,3,0,8,0,6045680,2020-03-04,3.23938204338386,1.07979401446129
Maryland,2020-03-11,1,0,9,0,6045680,2020-03-05,2.62723777814366,0.830805533377412
Maryland,2020-03-12,3,0,12,0,6045680,2020-03-06,2.62697950210245,0.728593022647943
Maryland,2020-03-13,6,0,18,0,6045680,2020-03-07,2.51210126272651,0.628025315681628
Maryland,2020-03-14,9,0,27,0,6045680,2020-03-08,3.0647839823541,0.612956796470819
Maryland,2020-03-15,-3,0,24,0,6045680,2020-03-09,2.03716239376026,0.424777722874029
Maryland,2020-03-16,18,0,42,0,6045680,2020-03-10,2.97667151157644,0.464877987869535
Maryland,2020-03-17,18,0,60,0,6045680,2020-03-11,3.00026961201725,0.400927891289919
Maryland,2020-03-18,25,0,85,0,6045680,2020-03-12,3.04866807497203,0.340851452823545
Maryland,2020-03-19,22,1,107,1,6045680,2020-03-13,2.68096181494593,0.269446800528663
Maryland,2020-03-20,42,1,149,2,6045680,2020-03-14,2.72131262049511,0.234213299088925
Maryland,2020-03-21,44,0,193,2,6045680,2020-03-15,2.55782656657784,0.196176342410888
Maryland,2020-03-22,51,1,244,3,6045680,2020-03-16,2.52799379831016,0.170051265151465
Maryland,2020-03-23,46,0,290,3,6045680,2020-03-17,2.18315994982051,0.138352140297506
Maryland,2020-03-24,59,1,349,4,6045680,2020-03-18,2.04603678220352,0.120147416838071
Maryland,2020-03-25,76,0,425,4,6045680,2020-03-19,1.99456523985769,0.108011763452555
Maryland,2020-03-26,158,0,583,4,6045680,2020-03-20,2.33242681671984,0.106794487637894
Maryland,2020-03-27,192,1,775,5,6045680,2020-03-21,2.43607362715321,0.09728740955987
Maryland,2020-03-28,220,0,995,5,6045680,2020-03-22,2.41652091618158,0.0852771712603127
Maryland,2020-03-29,244,5,1239,10,6045680,2020-03-23,2.3288088147689,0.073791131037711
Maryland,2020-03-30,174,5,1413,15,6045680,2020-03-24,2.07060680812708,0.0617610231481349
Maryland,2020-03-31,247,3,1660,18,6045680,2020-03-25,1.98299950054331,0.054746415262664
Maryland,2020-04-01,326,13,1986,31,6045680,2020-03-26,1.97661515264929,0.0500128502160868
Maryland,2020-04-02,345,5,2331,36,6045680,2020-03-27,1.85478033823748,0.0443504038405397
Maryland,2020-04-03,427,7,2758,43,6045680,2020-03-28,1.79507166614796,0.0403005485947763
Maryland,2020-04-04,367,11,3125,54,6045680,2020-03-29,1.66658090424418,0.0361022838514691
Maryland,2020-04-05,492,13,3617,67,6045680,2020-03-30,1.64215718686785,0.0336680144044664
Maryland,2020-04-06,428,24,4045,91,6045680,2020-03-31,1.6163233160825,0.0314994382126789
Maryland,2020-04-07,326,12,4371,103,6045680,2020-04-01,1.48499375384486,0.0285154207682838
Maryland,2020-04-08,1158,21,5529,124,6045680,2020-04-02,1.76946769620208,0.0297232149273239
Maryland,2020-04-09,656,14,6185,138,6045680,2020-04-03,1.68219589968279,0.0270934542753039
Maryland,2020-04-10,783,33,6968,171,6045680,2020-04-04,1.60842859015685,0.0247861551278306
Maryland,2020-04-11,726,35,7694,206,6045680,2020-04-05,1.55718979747258,0.0230347471586646
Maryland,2020-04-12,531,30,8225,236,6045680,2020-04-06,1.41504122208291,0.0208432643961176
Maryland,2020-04-13,711,26,8936,262,6045680,2020-04-07,1.38730096430762,0.0198347834786184
Maryland,2020-04-14,536,40,9472,302,6045680,2020-04-08,1.34913096436416,0.0188879090528856
Maryland,2020-04-15,560,9,10032,311,6045680,2020-04-09,1.11618114987316,0.0166316559702736
Maryland,2020-04-16,752,8,10784,319,6045680,2020-04-10,1.11375419435928,0.0164214097092054
Maryland,2020-04-17,788,15,11572,334,6045680,2020-04-11,1.10011909157955,0.0162115628474945
Maryland,2020-04-18,754,87,12326,421,6045680,2020-04-12,1.08916199489488,0.0160015233135428
Maryland,2020-04-19,521,40,12847,461,6045680,2020-04-13,1.07115654045914,0.0157540056617591
Maryland,2020-04-20,837,121,13684,582,6045680,2020-04-14,1.08739071052718,0.015779183755694
Maryland,2020-04-21,509,70,14193,652,6045680,2020-04-15,1.06543082674835,0.0155046607097415
Maryland,2020-04-22,582,46,14775,698,6045680,2020-04-16,1.05733644111575,0.0153511480536951
Maryland,2020-04-23,962,50,15737,748,6045680,2020-04-17,1.09345936365389,0.01553547894882
Maryland,2020-04-24,879,50,16616,798,6045680,2020-04-18,1.09525677709147,0.0154200351554463
Maryland,2020-04-25,1150,77,17766,875,6045680,2020-04-19,1.15907252584211,0.015713439171189
Maryland,2020-04-26,815,35,18581,910,6045680,2020-04-20,1.1858261691403,0.0156586500792625
Maryland,2020-04-27,906,35,19487,945,6045680,2020-04-21,1.1560793977996,0.0151748343831357
Maryland,2020-04-28,626,71,20113,1016,6045680,2020-04-22,1.14243822552154,0.0148468799006887
Maryland,2020-04-29,736,62,20849,1078,6045680,2020-04-23,1.14064103738332,0.0146344313329332
Maryland,2020-04-30,893,62,21742,1140,6045680,2020-04-24,1.09801042724215,0.0141681713466996
Maryland,2020-05-01,1730,-60,23472,1080,6045680,2020-04-25,1.22980726749372,0.014851488402521
Maryland,2020-05-02,1001,171,24473,1251,6045680,2020-04-26,1.15501246910236,0.0141023063818126
Maryland,2020-05-03,989,30,25462,1281,6045680,2020-04-27,1.14494933380007,0.0138015840509205
Maryland,2020-05-04,946,36,26408,1317,6045680,2020-04-28,1.1214146072851,0.0134787746153116
Maryland,2020-05-05,709,73,27117,1390,6045680,2020-04-29,1.10886385855106,0.013248727232317
Maryland,2020-05-06,1046,47,28163,1437,6045680,2020-04-30,1.13500085228226,0.0132705530487729
Maryland,2020-05-07,1211,66,29374,1503,6045680,2020-05-01,1.15540319127355,0.0132247031252339
Maryland,2020-05-08,1111,57,30485,1560,6045680,2020-05-02,1.0303446451214,0.01230267744099
Maryland,2020-05-09,1049,54,31534,1614,6045680,2020-05-03,1.02920392317791,0.0122472216113265
Maryland,2020-05-10,1053,30,32587,1644,6045680,2020-05-04,1.03711545378819,0.0122858213705069
Massachusetts,2020-03-08,16,0,22,0,6892503,2020-03-02,9.14576981860119,1.9498846769493
Massachusetts,2020-03-09,0,0,22,0,6892503,2020-03-03,3.71903400897705,0.792900714864786
Massachusetts,2020-03-10,19,0,41,0,6892503,2020-03-04,4.20562276737627,0.664967346218476
Massachusetts,2020-03-11,51,0,92,0,6892503,2020-03-05,5.98687728975224,0.627595268216209
Massachusetts,2020-03-12,15,0,107,0,6892503,2020-03-06,3.54305350392,0.344131777793286
Massachusetts,2020-03-13,16,0,123,0,6892503,2020-03-07,2.53935383248803,0.233766468405131
Massachusetts,2020-03-14,15,0,138,0,6892503,2020-03-08,2.18062620034066,0.189084271812088
Massachusetts,2020-03-15,0,0,138,0,6892503,2020-03-09,1.55788125032944,0.144026172542224
Massachusetts,2020-03-16,49,0,187,0,6892503,2020-03-10,1.98537132049766,0.154094699412653
Massachusetts,2020-03-17,30,0,217,0,6892503,2020-03-11,1.80610113150244,0.135754874166522
Massachusetts,2020-03-18,35,0,252,0,6892503,2020-03-12,1.40741316387759,0.110919696032982
Massachusetts,2020-03-19,76,0,328,0,6892503,2020-03-13,1.79370671308854,0.120385712176742
Massachusetts,2020-03-20,85,1,413,1,6892503,2020-03-14,2.06325465159186,0.120950129697889
Massachusetts,2020-03-21,110,0,523,1,6892503,2020-03-15,2.25724746940523,0.114890871155913
Massachusetts,2020-03-22,117,4,640,5,6892503,2020-03-16,2.34792192909856,0.104688664484055
Massachusetts,2020-03-23,137,4,777,9,6892503,2020-03-17,2.16713577525361,0.0891440541093605
Massachusetts,2020-03-24,382,2,1159,11,6892503,2020-03-18,2.78851029577538,0.0908063890150032
Massachusetts,2020-03-25,679,4,1838,15,6892503,2020-03-19,3.4855323494104,0.0874944800087496
Massachusetts,2020-03-26,579,10,2417,25,6892503,2020-03-20,3.06650566863115,0.067076536359762
Massachusetts,2020-03-27,823,10,3240,35,6892503,2020-03-21,2.89673437577986,0.0544714543276724
Massachusetts,2020-03-28,1017,9,4257,44,6892503,2020-03-22,2.76462771751751,0.0452367457241619
Massachusetts,2020-03-29,698,4,4955,48,6892503,2020-03-23,2.35297850055265,0.0358160131631433
Massachusetts,2020-03-30,797,8,5752,56,6892503,2020-03-24,2.12086265011874,0.0300657718876783
Massachusetts,2020-03-31,868,33,6620,89,6892503,2020-03-25,1.90160821745882,0.0257303205994819
Massachusetts,2020-04-01,1118,33,7738,122,6892503,2020-03-26,1.74066336211749,0.0226595865272485
Massachusetts,2020-04-02,1228,32,8966,154,6892503,2020-03-27,1.68664109323965,0.0208402069461404
Massachusetts,2020-04-03,1436,38,10402,192,6892503,2020-03-28,1.62826073668377,0.019238733335162
Massachusetts,2020-04-04,1334,24,11736,216,6892503,2020-03-29,1.514167569312,0.0175074599376974
Massachusetts,2020-04-05,764,15,12500,231,6892503,2020-03-30,1.38725807768619,0.0159697773718462
Massachusetts,2020-04-06,1337,29,13837,260,6892503,2020-03-31,1.38345912617182,0.0153850695577425
Massachusetts,2020-04-07,1365,96,15202,356,6892503,2020-04-01,1.37154772046234,0.0148044189405869
Massachusetts,2020-04-08,1588,77,16790,433,6892503,2020-04-02,1.35047935244561,0.0141935714534585
Massachusetts,2020-04-09,2151,70,18941,503,6892503,2020-04-03,1.39398713524909,0.013956629368583
Massachusetts,2020-04-10,2033,96,20974,599,6892503,2020-04-04,1.3738823490143,0.0133613526885045
Massachusetts,2020-04-11,1886,87,22860,686,6892503,2020-04-05,1.34562715706863,0.0127577689777266
Massachusetts,2020-04-12,2615,70,25475,756,6892503,2020-04-06,1.47008893167482,0.0129054510935469
Massachusetts,2020-04-13,1392,88,26867,844,6892503,2020-04-07,1.35478457666747,0.0118681047671814
Massachusetts,2020-04-14,1297,0,28164,844,6892503,2020-04-08,1.25421463756445,0.0110158776696735
Massachusetts,2020-04-15,1754,264,29918,1108,6892503,2020-04-09,1.21117018412065,0.0105703494946017
Massachusetts,2020-04-16,2263,0,32181,1108,6892503,2020-04-10,1.17635484950031,0.0102229904340469
Massachusetts,2020-04-17,2221,137,34402,1245,6892503,2020-04-11,1.15593216275371,0.00997494502498292
Massachusetts,2020-04-18,1970,159,36372,1404,6892503,2020-04-12,1.131350106581,0.00973242652557381
Massachusetts,2020-04-19,1705,302,38077,1706,6892503,2020-04-13,1.03055580428493,0.00917982803214651
Massachusetts,2020-04-20,0,0,38077,1706,6892503,2020-04-14,0.912098952404756,0.00861429580056729
Massachusetts,2020-04-21,3122,255,41199,1961,6892503,2020-04-15,1.08287924663503,0.00948435616551067
Massachusetts,2020-04-22,1745,221,42944,2182,6892503,2020-04-16,1.07396911741577,0.00940956586531825
Massachusetts,2020-04-23,3079,178,46023,2360,6892503,2020-04-17,1.12121843405362,0.00952960983555112
Massachusetts,2020-04-24,4946,196,50969,2556,6892503,2020-04-18,1.31186042736707,0.0101918398023596
Massachusetts,2020-04-25,2379,174,53348,2730,6892503,2020-04-19,1.26774969012837,0.00972978040752292
Massachusetts,2020-04-26,1590,169,54938,2899,6892503,2020-04-20,1.18834883368382,0.00915143926489199
Massachusetts,2020-04-27,1524,104,56462,3003,6892503,2020-04-21,1.24741298071884,0.00919955099567475
Massachusetts,2020-04-28,1840,150,58302,3153,6892503,2020-04-22,1.10925260168688,0.00848167470472885
Massachusetts,2020-04-29,1963,252,60265,3405,6892503,2020-04-23,1.09633319228407,0.00832997207989629
Massachusetts,2020-04-30,1940,157,62205,3562,6892503,2020-04-24,1.00942277764589,0.00793493883284915
Massachusetts,2020-05-01,2106,154,64311,3716,6892503,2020-04-25,0.8314171373235,0.00719767493621287
Massachusetts,2020-05-02,1952,130,66263,3846,6892503,2020-04-26,0.834169287480743,0.0073399005861416
Massachusetts,2020-05-03,1824,158,68087,4004,6892503,2020-04-27,0.885743113595754,0.00772404700599015
Massachusetts,2020-05-04,1000,86,69087,4090,6892503,2020-04-28,0.873438070252833,0.00777318895580249
Massachusetts,2020-05-05,1184,122,70271,4212,6892503,2020-04-29,0.84901203422621,0.00776009022859703
Massachusetts,2020-05-06,1754,208,72025,4420,6892503,2020-04-30,0.860175486960529,0.00793167548038738
Massachusetts,2020-05-07,1696,132,73721,4552,6892503,2020-05-01,0.86727332982313,0.0080813945024129
Massachusetts,2020-05-08,1612,150,75333,4702,6892503,2020-05-02,0.852229573288564,0.0081172084146825
Massachusetts,2020-05-09,1410,138,76743,4840,6892503,2020-05-03,0.833993486948415,0.00814631686196002
Massachusetts,2020-05-10,1050,139,77793,4979,6892503,2020-05-04,0.79834332169922,0.00810302505684004
Michigan,2020-03-08,0,0,0,0,9986857,2020-03-02,5,5
Michigan,2020-03-09,0,0,0,0,9986857,2020-03-03,5,5
Michigan,2020-03-10,0,0,0,0,9986857,2020-03-04,5,5
Michigan,2020-03-11,2,0,2,0,9986857,2020-03-05,15,8.66025403784439
Michigan,2020-03-12,0,0,2,0,9986857,2020-03-06,5.28714977316387,3.05253734478203
Michigan,2020-03-13,14,0,16,0,9986857,2020-03-07,17.6437181564893,4.27923021104903
Michigan,2020-03-14,9,0,25,0,9986857,2020-03-08,6.85708899089111,1.34478579119215
Michigan,2020-03-15,7,0,32,0,9986857,2020-03-09,3.9249119009536,0.683239463550625
Michigan,2020-03-16,22,0,54,0,9986857,2020-03-10,4.09918920167911,0.552734559196572
Michigan,2020-03-17,9,0,63,0,9986857,2020-03-11,2.98435121657631,0.373043902072039
Michigan,2020-03-18,56,1,119,1,9986857,2020-03-12,3.89047274453171,0.358147046024112
Michigan,2020-03-19,140,0,259,1,9986857,2020-03-13,5.48134324094156,0.341253524416111
Michigan,2020-03-20,143,0,402,1,9986857,2020-03-14,4.37393627441099,0.222339676191198
Michigan,2020-03-21,138,2,540,3,9986857,2020-03-15,3.42398035095971,0.15073233016218
Michigan,2020-03-22,495,6,1035,9,9986857,2020-03-16,4.44053075821445,0.14014190806843
Michigan,2020-03-23,294,6,1329,15,9986857,2020-03-17,3.37943328308652,0.0946059693237548
Michigan,2020-03-24,464,9,1793,24,9986857,2020-03-18,3.04524257801138,0.0731936423281278
Michigan,2020-03-25,503,19,2296,43,9986857,2020-03-19,2.71414949909437,0.0581573792716274
Michigan,2020-03-26,549,18,2845,61,9986857,2020-03-20,2.38913481988649,0.046972366793773
Michigan,2020-03-27,789,31,3634,92,9986857,2020-03-21,2.32910937164102,0.0409625543436483
Michigan,2020-03-28,1016,19,4650,111,9986857,2020-03-22,2.34362641771398,0.0365522946898664
Michigan,2020-03-29,838,21,5488,132,9986857,2020-03-23,2.00224446859372,0.0300014328052327
Michigan,2020-03-30,1010,52,6498,184,9986857,2020-03-24,1.9254127807043,0.0267780272236803
Michigan,2020-03-31,1117,75,7615,259,9986857,2020-03-25,1.83653196087198,0.0240671738794658
Michigan,2020-04-01,1700,76,9315,335,9986857,2020-03-26,1.89849218760903,0.0226589748965748
Michigan,2020-04-02,1476,82,10791,417,9986857,2020-03-27,1.82824082130212,0.0205084007459036
Michigan,2020-04-03,1953,62,12744,479,9986857,2020-03-28,1.79621712816762,0.0188181016462594
Michigan,2020-04-04,1481,61,14225,540,9986857,2020-03-29,1.63067305764522,0.0166638300246753
Michigan,2020-04-05,1493,77,15718,617,9986857,2020-03-30,1.54541922053015,0.0152787303763822
Michigan,2020-04-06,1503,110,17221,727,9986857,2020-03-31,1.46521315680931,0.0141488912017385
Michigan,2020-04-07,1749,118,18970,845,9986857,2020-04-01,1.42329150684989,0.0133561462484238
Michigan,2020-04-08,1376,114,20346,959,9986857,2020-04-02,1.27929416435549,0.0121798879287105
Michigan,2020-04-09,1158,117,21504,1076,9986857,2020-04-03,1.17821243719468,0.0113827653141721
Michigan,2020-04-10,930,200,22434,1276,9986857,2020-04-04,1.03391644554735,0.0105027044999542
Michigan,2020-04-11,1171,108,23605,1384,9986857,2020-04-05,0.997990993439104,0.0103039099355578
Michigan,2020-04-12,639,95,24244,1479,9986857,2020-04-06,0.914306095132626,0.00990132881850076
Michigan,2020-04-13,1391,123,25635,1602,9986857,2020-04-07,0.921455617068678,0.0100449403387221
Michigan,2020-04-14,1366,166,27001,1768,9986857,2020-04-08,0.898936328780729,0.010030372967778
Michigan,2020-04-15,1058,153,28059,1921,9986857,2020-04-09,0.883019694075218,0.0100538076617489
Michigan,2020-04-16,750,75,28809,1996,9986857,2020-04-10,0.858178426077068,0.0100400935303421
Michigan,2020-04-17,1214,231,30023,2227,9986857,2020-04-11,0.918690158998647,0.0105450386603347
Michigan,2020-04-18,768,81,30791,2308,9986857,2020-04-12,0.886497292333501,0.0104569153177331
Michigan,2020-04-19,633,83,31424,2391,9986857,2020-04-13,0.904279087087346,0.0106711204945293
Michigan,2020-04-20,576,77,32000,2468,9986857,2020-04-14,0.817959347693895,0.0102517593448057
Michigan,2020-04-21,667,107,32667,2575,9986857,2020-04-15,0.753827168600376,0.0100137139078893
Michigan,2020-04-22,1299,238,33966,2813,9986857,2020-04-16,0.827670433618955,0.0107680533382703
Michigan,2020-04-23,1330,164,35296,2977,9986857,2020-04-17,0.944648595728605,0.0117277544056351
Michigan,2020-04-24,1370,108,36666,3085,9986857,2020-04-18,0.977349398857601,0.0119904377379393
Michigan,2020-04-25,408,70,37074,3155,9986857,2020-04-19,0.924197170434665,0.0116586038706951
Michigan,2020-04-26,704,160,37778,3315,9986857,2020-04-20,0.945045232330866,0.0118548160108734
Michigan,2020-04-27,432,92,38210,3407,9986857,2020-04-21,0.934091047302712,0.0118524585454351
Michigan,2020-04-28,1052,161,39262,3568,9986857,2020-04-22,1.00347541048742,0.012355673154646
Michigan,2020-04-29,1137,102,40399,3670,9986857,2020-04-23,0.978699337979114,0.0122013747534922
Michigan,2020-04-30,980,119,41379,3789,9986857,2020-04-24,0.926312060303498,0.0118757956449166
Michigan,2020-05-01,977,77,42356,3866,9986857,2020-04-25,0.878367483757321,0.01164345737086
Michigan,2020-05-02,851,155,43207,4021,9986857,2020-04-26,0.970657717851199,0.0123935072799073
Michigan,2020-05-03,594,32,43801,4053,9986857,2020-04-27,0.961800372498044,0.0123920300913031
Michigan,2020-05-04,189,86,43990,4139,9986857,2020-04-28,0.927218490732677,0.0121949661487747
Michigan,2020-05-05,461,44,44451,4183,9986857,2020-04-29,0.843672305228089,0.0117108957270584
Michigan,2020-05-06,728,73,45179,4256,9986857,2020-04-30,0.801501458764085,0.0115916416128831
Michigan,2020-05-07,566,89,45745,4345,9986857,2020-05-01,0.763809353403928,0.0115582843991742
Michigan,2020-05-08,641,54,46386,4399,9986857,2020-05-02,0.740782281730992,0.0116676713372795
Michigan,2020-05-09,429,131,46815,4530,9986857,2020-05-03,0.70010728083712,0.011653896403358
Michigan,2020-05-10,367,25,47182,4555,9986857,2020-05-04,0.697645357251676,0.0119963162650479
Minnesota,2020-03-08,0,0,1,0,5639632,2020-03-02,3.43785639752253,2.43093157143374
Minnesota,2020-03-09,1,0,2,0,5639632,2020-03-03,4.22594088367282,2.43984810676795
Minnesota,2020-03-10,0,0,2,0,5639632,2020-03-04,3.03447962767621,1.7519576298893
Minnesota,2020-03-11,3,0,5,0,5639632,2020-03-05,4.76111094521982,1.94371540409478
Minnesota,2020-03-12,4,0,9,0,5639632,2020-03-06,5.00594754615279,1.58301960931737
Minnesota,2020-03-13,5,0,14,0,5639632,2020-03-07,4.03660709870855,1.07882862631336
Minnesota,2020-03-14,7,0,21,0,5639632,2020-03-08,3.82445590508481,0.83456469890819
Minnesota,2020-03-15,0,0,21,0,5639632,2020-03-09,2.48353518826236,0.541951809109461
Minnesota,2020-03-16,32,0,53,0,5639632,2020-03-10,4.71565007827442,0.653943005937084
Minnesota,2020-03-17,6,0,59,0,5639632,2020-03-11,3.13071420770091,0.411082914916459
Minnesota,2020-03-18,18,0,77,0,5639632,2020-03-12,2.68900815804649,0.314724599637515
Minnesota,2020-03-19,12,0,89,0,5639632,2020-03-13,2.24065249002048,0.248961387780054
Minnesota,2020-03-20,24,0,113,0,5639632,2020-03-14,2.21363569073104,0.221363569073104
Minnesota,2020-03-21,21,1,134,1,5639632,2020-03-15,2.04581288979204,0.191607932573017
Minnesota,2020-03-22,33,0,167,1,5639632,2020-03-16,2.18343660824963,0.180086816218772
Minnesota,2020-03-23,67,0,234,1,5639632,2020-03-17,2.20017419736446,0.163087762033179
Minnesota,2020-03-24,27,0,261,1,5639632,2020-03-18,1.97892500827273,0.138893306827982
Minnesota,2020-03-25,25,0,286,1,5639632,2020-03-19,1.70747459833014,0.117826941375955
Minnesota,2020-03-26,58,1,344,2,5639632,2020-03-20,1.82393359864982,0.113995849915614
Minnesota,2020-03-27,52,2,396,4,5639632,2020-03-21,1.75189297302222,0.103955722375073
Minnesota,2020-03-28,45,1,441,5,5639632,2020-03-22,1.65078477180664,0.0940621921029384
Minnesota,2020-03-29,62,4,503,9,5639632,2020-03-23,1.60075160028453,0.087198495988811
Minnesota,2020-03-30,73,1,576,10,5639632,2020-03-24,1.45905328796911,0.0787814724399465
Minnesota,2020-03-31,53,2,629,12,5639632,2020-03-25,1.439486637358,0.0749366811148597
Minnesota,2020-04-01,60,5,689,17,5639632,2020-03-26,1.45657365003655,0.0724672476033137
Minnesota,2020-04-02,53,1,742,18,5639632,2020-03-27,1.32312799032313,0.0662392503933506
Minnesota,2020-04-03,46,4,788,22,5639632,2020-03-28,1.22440671420061,0.0617631485476816
Minnesota,2020-04-04,77,2,865,24,5639632,2020-03-29,1.2725516788353,0.0617278233634706
Minnesota,2020-04-05,70,5,935,29,5639632,2020-03-30,1.23751246124943,0.0594710536017918
Minnesota,2020-04-06,51,1,986,30,5639632,2020-03-31,1.12300871424608,0.055393934779863
Minnesota,2020-04-07,83,4,1069,34,5639632,2020-04-01,1.17785314735735,0.0560882451122547
Minnesota,2020-04-08,85,5,1154,39,5639632,2020-04-02,1.20973653070049,0.0560399626284454
Minnesota,2020-04-09,86,11,1240,50,5639632,2020-04-03,1.24552193823557,0.0557572195533171
Minnesota,2020-04-10,96,7,1336,57,5639632,2020-04-04,1.30821786561404,0.0558333779285649
Minnesota,2020-04-11,91,7,1427,64,5639632,2020-04-05,1.26538823996344,0.0533297559867073
Minnesota,2020-04-12,194,6,1621,70,5639632,2020-04-06,1.46442203609613,0.0558711855414297
Minnesota,2020-04-13,0,0,1621,70,5639632,2020-04-07,1.24646283159451,0.0494254662567379
Minnesota,2020-04-14,74,9,1695,79,5639632,2020-04-08,1.16262992878497,0.0464309669410298
Minnesota,2020-04-15,114,8,1809,87,5639632,2020-04-09,1.18335490908619,0.0462022469503351
Minnesota,2020-04-16,0,0,1809,87,5639632,2020-04-10,0.996652244350862,0.0417451687754049
Minnesota,2020-04-17,261,24,2070,111,5639632,2020-04-11,1.28477934624575,0.047389800110105
Minnesota,2020-04-18,139,10,2209,121,5639632,2020-04-12,1.31048911482617,0.0468330602257875
Minnesota,2020-04-19,147,13,2356,134,5639632,2020-04-13,1.15426288830108,0.0425466945420281
Minnesota,2020-04-20,114,9,2470,143,5639632,2020-04-14,1.28921607671729,0.0442197466199982
Minnesota,2020-04-21,97,17,2567,160,5639632,2020-04-15,1.25999868452938,0.0426444944136771
Minnesota,2020-04-22,155,19,2722,179,5639632,2020-04-16,1.25104892638592,0.041381020504566
Minnesota,2020-04-23,220,21,2942,200,5639632,2020-04-17,1.47990440058532,0.0439467875568995
Minnesota,2020-04-24,243,21,3185,221,5639632,2020-04-18,1.33500406736267,0.0399623014542742
Minnesota,2020-04-25,261,23,3446,244,5639632,2020-04-19,1.3784658914583,0.0391774082421263
Minnesota,2020-04-26,156,28,3602,272,5639632,2020-04-20,1.29577988726146,0.0366942493591508
Minnesota,2020-04-27,209,14,3811,286,5639632,2020-04-21,1.31494842526135,0.0358948763317041
Minnesota,2020-04-28,370,15,4181,301,5639632,2020-04-22,1.49386199052413,0.0371727091772235
Minnesota,2020-04-29,463,18,4644,319,5639632,2020-04-23,1.62497127562033,0.0370557874222457
Minnesota,2020-04-30,492,24,5136,343,5639632,2020-04-24,1.64695996233813,0.0351532740031585
Minnesota,2020-05-01,594,27,5730,370,5639632,2020-04-25,1.68706400758536,0.033435079522718
Minnesota,2020-05-02,502,24,6232,394,5639632,2020-04-26,1.62291712007064,0.0307416983850527
Minnesota,2020-05-03,431,24,6663,418,5639632,2020-04-27,1.58240697930576,0.0285966787463488
Minnesota,2020-05-04,571,9,7234,427,5639632,2020-04-28,1.58609702263889,0.0271058400892915
Minnesota,2020-05-05,617,28,7851,455,5639632,2020-04-29,1.5246019036813,0.0251631070647684
Minnesota,2020-05-06,728,30,8579,485,5639632,2020-04-30,1.47955996947373,0.0235833245529288
Minnesota,2020-05-07,786,23,9365,508,5639632,2020-05-01,1.45349835271884,0.0223482931866951
Minnesota,2020-05-08,723,26,10088,534,5639632,2020-05-02,1.37618692263178,0.0208441405106472
Minnesota,2020-05-09,702,24,10790,558,5639632,2020-05-03,1.34014436087879,0.0198480016403412
Minnesota,2020-05-10,481,20,11271,578,5639632,2020-05-04,1.27250276183481,0.0187437023712081
Mississippi,2020-03-08,0,0,0,0,2976149,2020-03-02,5,5
Mississippi,2020-03-09,0,0,0,0,2976149,2020-03-03,5,5
Mississippi,2020-03-10,0,0,0,0,2976149,2020-03-04,5,5
Mississippi,2020-03-11,0,0,0,0,2976149,2020-03-05,5,5
Mississippi,2020-03-12,1,0,1,0,2976149,2020-03-06,10,7.07106781186548
Mississippi,2020-03-13,5,0,6,0,2976149,2020-03-07,18.2430991174051,6.89524334396512
Mississippi,2020-03-14,0,0,6,0,2976149,2020-03-08,4.66575982660086,1.76349145404882
Mississippi,2020-03-15,0,0,6,0,2976149,2020-03-09,2.67309185429898,1.01033375401537
Mississippi,2020-03-16,6,0,12,0,2976149,2020-03-10,3.87546514506046,1.07486063821454
Mississippi,2020-03-17,9,0,21,0,2976149,2020-03-11,4.39530066152305,0.937081249635003
Mississippi,2020-03-18,13,0,34,0,2976149,2020-03-12,4.23074666469878,0.715126708869731
Mississippi,2020-03-19,16,1,50,1,2976149,2020-03-13,3.69013071197107,0.521863289979897
Mississippi,2020-03-20,30,0,80,1,2976149,2020-03-14,3.59294335118739,0.414877362198223
Mississippi,2020-03-21,60,0,140,1,2976149,2020-03-15,4.26953516887163,0.367463080113037
Mississippi,2020-03-22,67,0,207,1,2976149,2020-03-16,3.88909524457768,0.273635786530711
Mississippi,2020-03-23,42,0,249,1,2976149,2020-03-17,2.87905337934009,0.186621312079369
Mississippi,2020-03-24,71,0,320,1,2976149,2020-03-18,2.60329168492861,0.150301115507265
Mississippi,2020-03-25,57,2,377,3,2976149,2020-03-19,2.26336857224782,0.122032654963495
Mississippi,2020-03-26,108,3,485,6,2976149,2020-03-20,2.28399622350448,0.109383580910922
Mississippi,2020-03-27,94,2,579,8,2976149,2020-03-21,2.09344892386963,0.0936218820239255
Mississippi,2020-03-28,84,5,663,13,2976149,2020-03-22,1.79595690453006,0.0784567416538159
Mississippi,2020-03-29,96,1,759,14,2976149,2020-03-23,1.6333763182405,0.0694582263127382
Mississippi,2020-03-30,88,2,847,16,2976149,2020-03-24,1.57682039275017,0.0644271346389416
Mississippi,2020-03-31,90,4,937,20,2976149,2020-03-25,1.46609701503039,0.0589750709426256
Mississippi,2020-04-01,136,2,1073,22,2976149,2020-03-26,1.51665644177459,0.0574474591513872
Mississippi,2020-04-02,104,4,1177,26,2976149,2020-03-27,1.37515300600678,0.0522377430949122
Mississippi,2020-04-03,181,3,1358,29,2976149,2020-03-28,1.43923166125317,0.0515327599905938
Mississippi,2020-04-04,97,6,1455,35,2976149,2020-03-29,1.35390816780254,0.0480786887433165
Mississippi,2020-04-05,183,8,1638,43,2976149,2020-03-30,1.40295957000265,0.0472937574568637
Mississippi,2020-04-06,100,8,1738,51,2976149,2020-03-31,1.32236662604454,0.0442761094929823
Mississippi,2020-04-07,177,9,1915,60,2976149,2020-04-01,1.36313489038677,0.0435659800341131
Mississippi,2020-04-08,88,7,2003,67,2976149,2020-04-02,1.2138066105054,0.0397809049037193
Mississippi,2020-04-09,257,9,2260,76,2976149,2020-04-03,1.3535972477247,0.0411125885167308
Mississippi,2020-04-10,209,6,2469,82,2976149,2020-04-04,1.30695325581419,0.0391929236391504
Mississippi,2020-04-11,173,11,2642,93,2976149,2020-04-05,1.31304609735275,0.0380953311314907
Mississippi,2020-04-12,139,3,2781,96,2976149,2020-04-06,1.19283822564209,0.0352670014615896
Mississippi,2020-04-13,161,2,2942,98,2976149,2020-04-07,1.20908361093524,0.0348307487828444
Mississippi,2020-04-14,145,13,3087,111,2976149,2020-04-08,1.13548835580043,0.0331538279137621
Mississippi,2020-04-15,273,11,3360,122,2976149,2020-04-09,1.28081204769774,0.0347564586079888
Mississippi,2020-04-16,264,7,3624,129,2976149,2020-04-10,1.22649527875747,0.0331970547792699
Mississippi,2020-04-17,169,11,3793,140,2976149,2020-04-11,1.13573376611995,0.0312010061219611
Mississippi,2020-04-18,181,12,3974,152,2976149,2020-04-12,1.11321519532482,0.0304904652382375
Mississippi,2020-04-19,300,7,4274,159,2976149,2020-04-13,1.22436642417605,0.0316764214593807
Mississippi,2020-04-20,238,10,4512,169,2976149,2020-04-14,1.23756466749727,0.0312233724237293
Mississippi,2020-04-21,204,14,4716,183,2976149,2020-04-15,1.2243342763933,0.0303253768112327
Mississippi,2020-04-22,178,10,4894,193,2976149,2020-04-16,1.10349477548965,0.0281654108976105
Mississippi,2020-04-23,259,8,5153,201,2976149,2020-04-17,1.07662972723818,0.0275245768914661
Mississippi,2020-04-24,281,8,5434,209,2976149,2020-04-18,1.14275242170794,0.0282010691796278
Mississippi,2020-04-25,284,12,5718,221,2976149,2020-04-19,1.18529835550774,0.0283746142603507
Mississippi,2020-04-26,193,6,5911,227,2976149,2020-04-20,1.07339562572023,0.0265217924690713
Mississippi,2020-04-27,183,2,6094,229,2976149,2020-04-21,1.02013982486211,0.0256400722558896
Mississippi,2020-04-28,248,10,6342,239,2976149,2020-04-22,1.04752312595263,0.0259698740341232
Mississippi,2020-04-29,227,11,6569,250,2976149,2020-04-23,1.07291413292514,0.026207642682668
Mississippi,2020-04-30,246,11,6815,261,2976149,2020-04-24,1.05062732832076,0.0257633639464393
Mississippi,2020-05-01,397,20,7212,281,2976149,2020-04-25,1.11250851160894,0.0263763907710687
Mississippi,2020-05-02,229,10,7441,291,2976149,2020-04-26,1.05679459102358,0.025452002136781
Mississippi,2020-05-03,109,12,7550,303,2976149,2020-04-27,0.992027414958647,0.024496370961061
Mississippi,2020-05-04,327,7,7877,310,2976149,2020-04-28,1.08184404504621,0.0256134001175957
Mississippi,2020-05-05,330,32,8207,342,2976149,2020-04-29,1.11814425258796,0.0258846332559909
Mississippi,2020-05-06,217,32,8424,374,2976149,2020-04-30,1.08543501089536,0.0251950276771782
Mississippi,2020-05-07,262,22,8686,396,2976149,2020-05-01,1.07487913861047,0.0248431528794014
Mississippi,2020-05-08,404,13,9090,409,2976149,2020-05-02,1.06387680176121,0.0245430170444529
Mississippi,2020-05-09,288,12,9378,421,2976149,2020-05-03,1.08419821975864,0.0246281507623506
Mississippi,2020-05-10,123,9,9501,430,2976149,2020-05-04,1.07538783317776,0.0243402599404489
Missouri,2020-03-08,1,0,1,0,6626371,2020-03-02,10,7.07106781186548
Missouri,2020-03-09,0,0,1,0,6626371,2020-03-03,5.21231403354432,3.68566259879299
Missouri,2020-03-10,0,0,1,0,6626371,2020-03-04,3.43785639752253,2.43093157143374
Missouri,2020-03-11,0,0,1,0,6626371,2020-03-05,2.81729392244855,1.99212763715902
Missouri,2020-03-12,1,0,2,0,6626371,2020-03-06,3.72702916098785,2.15180128937392
Missouri,2020-03-13,2,0,4,0,6626371,2020-03-07,4.70739337788355,2.10521031795599
Missouri,2020-03-14,0,0,4,0,6626371,2020-03-08,2.96599687823974,1.32643412815925
Missouri,2020-03-15,1,0,5,0,6626371,2020-03-09,2.21567868422764,0.990881630846057
Missouri,2020-03-16,1,0,6,0,6626371,2020-03-10,2.26783415793422,0.925839418032198
Missouri,2020-03-17,6,0,12,0,6626371,2020-03-11,3.84155951936717,1.1089627113073
Missouri,2020-03-18,6,1,18,1,6626371,2020-03-12,3.86730819570431,0.911533283373609
Missouri,2020-03-19,21,0,39,1,6626371,2020-03-13,5.2365203429904,0.84947577182005
Missouri,2020-03-20,34,2,73,3,6626371,2020-03-14,5.33084294775691,0.637157600302755
Missouri,2020-03-21,8,0,81,3,6626371,2020-03-15,3.18319498522694,0.360425857697671
Missouri,2020-03-22,19,0,100,3,6626371,2020-03-16,2.66358169598314,0.271850668473988
Missouri,2020-03-23,87,1,187,4,6626371,2020-03-17,3.80343569891597,0.28192941127859
Missouri,2020-03-24,70,3,257,7,6626371,2020-03-18,3.34763571743148,0.213437457725339
Missouri,2020-03-25,97,1,354,8,6626371,2020-03-19,3.07906487884996,0.167727351601562
Missouri,2020-03-26,166,1,520,9,6626371,2020-03-20,3.10096563624954,0.14124511431495
Missouri,2020-03-27,146,0,666,9,6626371,2020-03-21,2.68901423709971,0.110331590569752
Missouri,2020-03-28,170,1,836,10,6626371,2020-03-22,2.53841788570881,0.092321365926114
Missouri,2020-03-29,79,3,915,13,6626371,2020-03-23,2.09447621127803,0.0733213331280767
Missouri,2020-03-30,136,0,1051,13,6626371,2020-03-24,1.81105414923837,0.0615776884324684
Missouri,2020-03-31,306,2,1357,15,6626371,2020-03-25,1.98724352481363,0.059890429978501
Missouri,2020-04-01,256,3,1613,18,6626371,2020-03-26,1.91563419887397,0.0539668797893929
Missouri,2020-04-02,244,4,1857,22,6626371,2020-03-27,1.71593383505269,0.0469107613066203
Missouri,2020-04-03,7,3,1864,25,6626371,2020-03-28,1.34374846227214,0.0388068497115659
Missouri,2020-04-04,446,8,2310,33,6626371,2020-03-29,1.54560161087754,0.0402440381060707
Missouri,2020-04-05,37,11,2347,44,6626371,2020-03-30,1.37292483545298,0.0362680049258362
Missouri,2020-04-06,389,3,2736,47,6626371,2020-03-31,1.49844160781165,0.0364931236476053
Missouri,2020-04-07,394,18,3130,65,6626371,2020-04-01,1.4452820522685,0.0343143519874189
Missouri,2020-04-08,79,21,3209,86,6626371,2020-04-02,1.19325251509169,0.0298593191230573
Missouri,2020-04-09,223,7,3432,93,6626371,2020-04-03,1.13244199014317,0.0285258016281323
Missouri,2020-04-10,465,6,3897,99,6626371,2020-04-04,1.43506080391381,0.0318196082392661
Missouri,2020-04-11,211,17,4108,116,6626371,2020-04-05,1.17922292183122,0.0278022747455951
Missouri,2020-04-12,161,2,4269,118,6626371,2020-04-06,1.20602903795052,0.0275022434709128
Missouri,2020-04-13,246,5,4515,123,6626371,2020-04-07,1.08037286036752,0.0256072926478391
Missouri,2020-04-14,231,26,4746,149,6626371,2020-04-08,0.965634092662995,0.0240136170516688
Missouri,2020-04-15,45,4,4791,153,6626371,2020-04-09,0.955743656444635,0.0240215466665669
Missouri,2020-04-16,383,16,5174,169,6626371,2020-04-10,1.0684819624641,0.0255928411725525
Missouri,2020-04-17,197,15,5371,184,6626371,2020-04-11,0.89653543156912,0.0233437942983413
Missouri,2020-04-18,208,13,5579,197,6626371,2020-04-12,0.909575291217052,0.0237074448611146
Missouri,2020-04-19,164,2,5743,199,6626371,2020-04-13,0.934170070155131,0.0243237168208753
Missouri,2020-04-20,147,1,5890,200,6626371,2020-04-14,0.884689349504373,0.0238496264951506
Missouri,2020-04-21,176,24,6066,224,6626371,2020-04-15,0.868811373907096,0.0239041931306646
Missouri,2020-04-22,211,14,6277,238,6626371,2020-04-16,1.00602792202914,0.0260888268475727
Missouri,2020-04-23,229,14,6506,252,6626371,2020-04-17,0.903625662969673,0.0247499018885714
Missouri,2020-04-24,282,20,6788,272,6626371,2020-04-18,0.974213204345204,0.0258711596636431
Missouri,2020-04-25,147,9,6935,281,6626371,2020-04-19,0.940260296291252,0.0255245546924695
Missouri,2020-04-26,185,2,7120,283,6626371,2020-04-20,0.963571019202036,0.0259572763448685
Missouri,2020-04-27,185,20,7305,303,6626371,2020-04-21,0.998251795964472,0.0265282421745519
Missouri,2020-04-28,145,27,7450,330,6626371,2020-04-22,0.976301374037471,0.0262336677463858
Missouri,2020-04-29,210,8,7660,338,6626371,2020-04-23,0.978391113400353,0.026299316058229
Missouri,2020-04-30,158,12,7818,350,6626371,2020-04-24,0.93235812523195,0.0257306286423805
Missouri,2020-05-01,249,10,8067,360,6626371,2020-04-25,0.920430477061388,0.0257268139408978
Missouri,2020-05-02,289,16,8356,376,6626371,2020-04-26,1.04027363699582,0.0275865756482667
Missouri,2020-05-03,262,5,8618,381,6626371,2020-04-27,1.0905734131471,0.028167875303407
Missouri,2020-05-04,328,5,8946,386,6626371,2020-04-28,1.16998805063206,0.0288731953907383
Missouri,2020-05-05,175,23,9121,409,6626371,2020-04-29,1.15084399339009,0.0281448098456047
Missouri,2020-05-06,202,19,9323,428,6626371,2020-04-30,1.10794677425155,0.0271607799131289
Missouri,2020-05-07,258,21,9581,449,6626371,2020-05-01,1.14853582174166,0.027346090993849
Missouri,2020-05-08,152,34,9733,483,6626371,2020-05-02,1.05594438066029,0.0258626631567538
Missouri,2020-05-09,178,11,9911,494,6626371,2020-05-03,0.972648937722159,0.024657629375282
Missouri,2020-05-10,157,9,10068,503,6626371,2020-05-04,0.913667260466217,0.0239858082156941
Montana,2020-03-08,0,0,0,0,1068778,2020-03-02,5,5
Montana,2020-03-09,0,0,0,0,1068778,2020-03-03,5,5
Montana,2020-03-10,0,0,0,0,1068778,2020-03-04,5,5
Montana,2020-03-11,0,0,0,0,1068778,2020-03-05,5,5
Montana,2020-03-12,0,0,0,0,1068778,2020-03-06,5,5
Montana,2020-03-13,1,0,1,0,1068778,2020-03-07,10,7.07106781186548
Montana,2020-03-14,4,0,5,0,1068778,2020-03-08,15.636942100633,6.38375488066581
Montana,2020-03-15,1,0,6,0,1068778,2020-03-09,5.31678625540428,2.00955631512658
Montana,2020-03-16,0,0,6,0,1068778,2020-03-10,2.89179807314595,1.09299693476571
Montana,2020-03-17,2,0,8,0,1068778,2020-03-11,2.78957938893215,0.929859796310716
Montana,2020-03-18,2,0,10,0,1068778,2020-03-12,2.63442175401534,0.794308045238074
Montana,2020-03-19,1,0,11,0,1068778,2020-03-13,2.22788632389748,0.643135384413049
Montana,2020-03-20,9,0,20,0,1068778,2020-03-14,3.04177188532494,0.680160870763425
Montana,2020-03-21,7,0,27,0,1068778,2020-03-15,2.56365860518079,0.534559771901649
Montana,2020-03-22,7,0,34,0,1068778,2020-03-16,2.45749334477706,0.45634505772623
Montana,2020-03-23,0,0,34,0,1068778,2020-03-17,1.92480445416985,0.357427214041766
Montana,2020-03-24,17,0,51,0,1068778,2020-03-18,2.46709989068666,0.371929302624294
Montana,2020-03-25,14,0,65,0,1068778,2020-03-19,2.47958632938992,0.331348660910909
Montana,2020-03-26,25,0,90,0,1068778,2020-03-20,2.73015238359302,0.305240315932353
Montana,2020-03-27,19,1,109,1,1068778,2020-03-21,2.29394885386976,0.24180344047204
Montana,2020-03-28,20,0,129,1,1068778,2020-03-22,2.06947528702414,0.203911459074234
Montana,2020-03-29,25,0,154,1,1068778,2020-03-23,2.00806933827015,0.182551758024559
Montana,2020-03-30,17,4,171,5,1068778,2020-03-24,1.91381949709382,0.162915134559453
Montana,2020-03-31,27,0,198,5,1068778,2020-03-25,1.73896312760886,0.142941888570127
Montana,2020-04-01,10,1,208,6,1068778,2020-03-26,1.47614436071019,0.123012030059182
Montana,2020-04-02,33,0,241,6,1068778,2020-03-27,1.42561242428958,0.115632436724964
Montana,2020-04-03,2,-1,243,5,1068778,2020-03-28,1.17703365116764,0.101302927308844
Montana,2020-04-04,22,1,265,6,1068778,2020-03-29,1.15635497191394,0.0987940725293528
Montana,2020-04-05,21,0,286,6,1068778,2020-03-30,1.10099271488979,0.0954681759454367
Montana,2020-04-06,13,0,299,6,1068778,2020-03-31,1.05270219104636,0.0926852598197735
Montana,2020-04-07,20,0,319,6,1068778,2020-04-01,0.991006178197013,0.0897214836758117
Montana,2020-04-08,13,0,332,6,1068778,2020-04-02,1.0222790898784,0.0914354214777886
Montana,2020-04-09,22,0,354,6,1068778,2020-04-03,0.934264236841818,0.0875018628494246
Montana,2020-04-10,11,0,365,6,1068778,2020-04-04,1.02282469947948,0.0922249973108488
Montana,2020-04-11,12,0,377,6,1068778,2020-04-05,0.942041584553596,0.0886198177474719
Montana,2020-04-12,10,0,387,6,1068778,2020-04-06,0.859307286033878,0.0850840997928399
Montana,2020-04-13,7,1,394,7,1068778,2020-04-07,0.83476042327576,0.0851973789373049
Montana,2020-04-14,5,0,399,7,1068778,2020-04-08,0.731944748301674,0.0813271942557416
Montana,2020-04-15,5,0,404,7,1068778,2020-04-09,0.698304166559931,0.0817303207460122
Montana,2020-04-16,11,0,415,7,1068778,2020-04-10,0.634616237761779,0.080596342792129
Montana,2020-04-17,7,1,422,8,1068778,2020-04-11,0.642069553057405,0.0843078626598042
Montana,2020-04-18,4,2,426,10,1068778,2020-04-12,0.598613644235404,0.0846567534299292
Montana,2020-04-19,7,0,433,10,1068778,2020-04-13,0.611651866700472,0.0892185943359357
Montana,2020-04-20,0,0,433,10,1068778,2020-04-14,0.565292420319569,0.0893805796119543
Montana,2020-04-21,4,2,437,12,1068778,2020-04-15,0.602333316102974,0.0964505218828651
Montana,2020-04-22,2,2,439,14,1068778,2020-04-16,0.604574913739383,0.10076248562323
Montana,2020-04-23,3,0,442,14,1068778,2020-04-17,0.508962614617409,0.0961848932076337
Montana,2020-04-24,2,0,444,14,1068778,2020-04-18,0.461562111484777,0.0962423532271946
Montana,2020-04-25,1,0,445,14,1068778,2020-04-19,0.450018648530668,0.100627228925716
Montana,2020-04-26,3,0,448,14,1068778,2020-04-20,0.404414374492941,0.101103593623235
Montana,2020-04-27,1,0,449,14,1068778,2020-04-21,0.486311621031132,0.117947892969218
Montana,2020-04-28,2,1,451,15,1068778,2020-04-22,0.478209101628539,0.123473059107476
Montana,2020-04-29,0,1,451,16,1068778,2020-04-23,0.459248089677956,0.127372502730212
Montana,2020-04-30,2,0,453,16,1068778,2020-04-24,0.473034509751988,0.136553300770647
Montana,2020-05-01,0,0,453,16,1068778,2020-04-25,0.439292521277339,0.138916492631437
Montana,2020-05-02,2,0,455,16,1068778,2020-04-26,0.541722351387378,0.163335434554636
Montana,2020-05-03,0,0,455,16,1068778,2020-04-27,0.433865825702646,0.153394733739721
Montana,2020-05-04,2,0,457,16,1068778,2020-04-28,0.545786049743296,0.181928683247765
Montana,2020-05-05,-1,0,456,16,1068778,2020-04-29,0.46908963926782,0.17729921829995
Montana,2020-05-06,0,0,456,16,1068778,2020-04-30,0.521757643064987,0.197205852599594
Montana,2020-05-07,0,0,456,16,1068778,2020-05-01,0.414017337040926,0.18515418189739
Montana,2020-05-08,2,0,458,16,1068778,2020-05-02,0.655641156549533,0.247809064218405
Montana,2020-05-09,0,0,458,16,1068778,2020-05-03,0.509336733572621,0.227782311941216
Montana,2020-05-10,0,0,458,16,1068778,2020-05-04,0.561095610188267,0.250929585251538
Nebraska,2020-03-08,0,0,1,0,1934408,2020-03-02,3.43785639752253,2.43093157143374
Nebraska,2020-03-09,2,0,3,0,1934408,2020-03-03,5.6345878448971,2.81729392244855
Nebraska,2020-03-10,0,0,3,0,1934408,2020-03-04,3.41196747263421,1.70598373631711
Nebraska,2020-03-11,2,0,5,0,1934408,2020-03-05,3.65415172696143,1.49180119562758
Nebraska,2020-03-12,5,0,10,0,1934408,2020-03-06,4.73358897854279,1.42723077759892
Nebraska,2020-03-13,4,0,14,0,1934408,2020-03-07,3.61277382721752,0.965554419810857
Nebraska,2020-03-14,4,0,18,0,1934408,2020-03-08,3.07294169126629,0.724299302695083
Nebraska,2020-03-15,-1,0,17,0,1934408,2020-03-09,2.204698027184,0.519652308496803
Nebraska,2020-03-16,1,0,18,0,1934408,2020-03-10,1.68623300143903,0.408971574960906
Nebraska,2020-03-17,5,0,23,0,1934408,2020-03-11,1.95110050886296,0.41597602617138
Nebraska,2020-03-18,1,0,24,0,1934408,2020-03-12,1.60803230362919,0.350901416729284
Nebraska,2020-03-19,5,0,29,0,1934408,2020-03-13,1.44038014723452,0.314316716867325
Nebraska,2020-03-20,8,0,37,0,1934408,2020-03-14,1.60226500020567,0.320453000041135
Nebraska,2020-03-21,1,0,38,0,1934408,2020-03-15,1.28212973176969,0.273350977274124
Nebraska,2020-03-22,13,0,51,0,1934408,2020-03-16,1.93783820841458,0.327554441363413
Nebraska,2020-03-23,0,0,51,0,1934408,2020-03-17,1.62640192945739,0.278925629774989
Nebraska,2020-03-24,15,0,66,0,1934408,2020-03-18,1.85414462782187,0.279522819888104
Nebraska,2020-03-25,5,0,71,0,1934408,2020-03-19,1.75150890487701,0.252808534429692
Nebraska,2020-03-26,3,0,74,0,1934408,2020-03-20,1.4586197076991,0.215061742989239
Nebraska,2020-03-27,8,0,82,0,1934408,2020-03-21,1.33871449673687,0.197382684131803
Nebraska,2020-03-28,14,2,96,2,1934408,2020-03-22,1.62421844659072,0.211455230756611
Nebraska,2020-03-29,12,0,108,2,1934408,2020-03-23,1.43923314926788,0.18898057088383
Nebraska,2020-03-30,37,0,145,2,1934408,2020-03-24,2.160622341521,0.221675174943208
Nebraska,2020-03-31,27,1,172,3,1934408,2020-03-25,2.00855731155248,0.194174564341725
Nebraska,2020-04-01,38,1,210,4,1934408,2020-03-26,2.16183226257674,0.182708173472611
Nebraska,2020-04-02,36,1,246,5,1934408,2020-03-27,2.17618138994475,0.165452007290413
Nebraska,2020-04-03,33,1,279,6,1934408,2020-03-28,2.01209565288893,0.142993411523976
Nebraska,2020-04-04,42,0,321,6,1934408,2020-03-29,1.90484927355619,0.126708688873887
Nebraska,2020-04-05,43,2,364,8,1934408,2020-03-30,1.83604543554161,0.114529367572127
Nebraska,2020-04-06,53,1,417,9,1934408,2020-03-31,1.67390396446991,0.101309276634065
Nebraska,2020-04-07,30,1,447,10,1934408,2020-04-01,1.49186693142097,0.0897998366147812
Nebraska,2020-04-08,72,2,519,12,1934408,2020-04-02,1.52926059010107,0.0868561649795552
Nebraska,2020-04-09,49,2,568,14,1934408,2020-04-03,1.45145317418297,0.0807610149652812
Nebraska,2020-04-10,67,1,635,15,1934408,2020-04-04,1.47345372813306,0.0779834409081835
Nebraska,2020-04-11,64,2,699,17,1934408,2020-04-05,1.4357435011293,0.0737491898982389
Nebraska,2020-04-12,92,0,791,17,1934408,2020-04-06,1.49370373592523,0.0722008952671376
Nebraska,2020-04-13,23,0,814,17,1934408,2020-04-07,1.26910815364184,0.0636146435853648
Nebraska,2020-04-14,83,3,897,20,1934408,2020-04-08,1.36093245950759,0.0640838066746882
Nebraska,2020-04-15,4,0,901,20,1934408,2020-04-09,1.08748048020105,0.0555676567558178
Nebraska,2020-04-16,51,1,952,21,1934408,2020-04-10,1.07055953311221,0.0545607659317411
Nebraska,2020-04-17,114,3,1066,24,1934408,2020-04-11,1.19646149453424,0.0575647804953638
Nebraska,2020-04-18,183,0,1249,24,1934408,2020-04-12,1.47807963347481,0.0629683094161775
Nebraska,2020-04-19,225,4,1474,28,1934408,2020-04-13,1.68108322861297,0.0642778237649563
Nebraska,2020-04-20,174,5,1648,33,1934408,2020-04-14,1.80150082759172,0.0623435068990463
Nebraska,2020-04-21,37,0,1685,33,1934408,2020-04-15,1.46234976191191,0.0520610301183945
Nebraska,2020-04-22,128,5,1813,38,1934408,2020-04-16,1.53517499273762,0.0508068767750077
Nebraska,2020-04-23,389,9,2202,47,1934408,2020-04-17,1.91435003252222,0.0541243501705947
Nebraska,2020-04-24,222,3,2424,50,1934408,2020-04-18,1.76756297574656,0.0479474116604585
Nebraska,2020-04-25,295,0,2719,50,1934408,2020-04-19,1.64454492697244,0.0428784824061437
Nebraska,2020-04-26,311,6,3030,56,1934408,2020-04-20,1.54151402524788,0.0390663803611919
Nebraska,2020-04-27,328,0,3358,56,1934408,2020-04-21,1.5302022849014,0.0369933653261182
Nebraska,2020-04-28,159,0,3517,56,1934408,2020-04-22,1.48727118812521,0.0347383296626492
Nebraska,2020-04-29,334,0,3851,56,1934408,2020-04-23,1.50979003408369,0.0334355091878899
Nebraska,2020-04-30,430,14,4281,70,1934408,2020-04-24,1.40188473022186,0.0307383561196288
Nebraska,2020-05-01,727,3,5008,73,1934408,2020-04-25,1.61195532438144,0.0317046327839002
Nebraska,2020-05-02,309,0,5317,73,1934408,2020-04-26,1.45409116544691,0.0285225595857309
Nebraska,2020-05-03,344,5,5661,78,1934408,2020-04-27,1.34279461829699,0.0261737921640902
Nebraska,2020-05-04,376,0,6037,78,1934408,2020-04-28,1.28264844568069,0.0247765162887285
Nebraska,2020-05-05,336,0,6373,78,1934408,2020-04-29,1.29888827168872,0.0243005820039348
Nebraska,2020-05-06,316,0,6689,78,1934408,2020-04-30,1.22322440404431,0.0229574390859903
Nebraska,2020-05-07,645,13,7334,91,1934408,2020-05-01,1.2607639317259,0.0228138856051535
Nebraska,2020-05-08,484,-1,7818,90,1934408,2020-05-02,1.10801279002844,0.0208984631993221
Nebraska,2020-05-09,275,0,8093,90,1934408,2020-05-03,1.07015522748067,0.0203076110772405
Nebraska,2020-05-10,78,0,8171,90,1934408,2020-05-04,0.959614727690851,0.0191502103329174
Nevada,2020-03-08,2,0,4,0,3080156,2020-03-02,4.58018506361127,2.0483210303528
Nevada,2020-03-09,0,0,4,0,3080156,2020-03-03,2.97221831975624,1.32921644138903
Nevada,2020-03-10,0,0,4,0,3080156,2020-03-04,2.22528956816471,0.995179748807489
Nevada,2020-03-11,3,0,7,0,3080156,2020-03-05,3.03621802374999,1.07346517687722
Nevada,2020-03-12,3,0,10,0,3080156,2020-03-06,2.87289278460791,0.908488467282452
Nevada,2020-03-13,8,0,18,0,3080156,2020-03-07,3.63731060040646,0.882177399920861
Nevada,2020-03-14,2,0,20,0,3080156,2020-03-08,2.74366424855823,0.629439747077409
Nevada,2020-03-15,0,0,20,0,3080156,2020-03-09,1.81442200500317,0.44006197506312
Nevada,2020-03-16,25,1,45,1,3080156,2020-03-10,3.87917128520773,0.598569124384306
Nevada,2020-03-17,10,0,55,1,3080156,2020-03-11,3.17733783672417,0.440617480376186
Nevada,2020-03-18,0,0,55,1,3080156,2020-03-12,2.04674596574578,0.292392280820826
Nevada,2020-03-19,40,0,95,1,3080156,2020-03-13,2.94407785206808,0.317468079315323
Nevada,2020-03-20,66,1,161,2,3080156,2020-03-14,3.63725123693847,0.303104269744873
Nevada,2020-03-21,0,0,161,2,3080156,2020-03-15,2.3509395585896,0.197286465205064
Nevada,2020-03-22,29,0,190,2,3080156,2020-03-16,2.17794521865078,0.16655163355555
Nevada,2020-03-23,55,2,245,4,3080156,2020-03-17,2.08923198707713,0.14736306225964
Nevada,2020-03-24,33,0,278,4,3080156,2020-03-18,1.91600085592803,0.128018192065148
Nevada,2020-03-25,45,2,323,6,3080156,2020-03-19,1.94615450387691,0.118659134328985
Nevada,2020-03-26,97,4,420,10,3080156,2020-03-20,1.9928966533605,0.110376337140432
Nevada,2020-03-27,116,0,536,10,3080156,2020-03-21,1.92138841252189,0.0990880415495268
Nevada,2020-03-28,90,0,626,10,3080156,2020-03-22,2.00935900623203,0.0930817585141205
Nevada,2020-03-29,294,5,920,15,3080156,2020-03-23,2.63030129988005,0.0972852078499952
Nevada,2020-03-30,92,0,1012,15,3080156,2020-03-24,2.09829326173799,0.0757156362189502
Nevada,2020-03-31,102,11,1114,26,3080156,2020-03-25,1.84504541385786,0.0637740989584836
Nevada,2020-04-01,165,5,1279,31,3080156,2020-03-26,1.80714876008258,0.0584168231400542
Nevada,2020-04-02,184,7,1463,38,3080156,2020-03-27,1.70413505982565,0.052741656038949
Nevada,2020-04-03,51,5,1514,43,3080156,2020-03-28,1.40208219688783,0.0448107413481795
Nevada,2020-04-04,228,3,1742,46,3080156,2020-03-29,1.4794776465323,0.0442671764010909
Nevada,2020-04-05,113,0,1855,46,3080156,2020-03-30,1.14296765653061,0.0373590665644552
Nevada,2020-04-06,98,0,1953,46,3080156,2020-03-31,1.11459695623297,0.0363155312186095
Nevada,2020-04-07,171,26,2124,72,3080156,2020-04-01,1.18335306739215,0.0372167772451185
Nevada,2020-04-08,135,0,2259,72,3080156,2020-04-02,1.11522899534649,0.0356065215261214
Nevada,2020-04-09,197,9,2456,81,3080156,2020-04-03,1.10545610899966,0.0350629386521754
Nevada,2020-04-10,266,9,2722,90,3080156,2020-04-04,1.322300847,0.0380291944139298
Nevada,2020-04-11,-20,12,2702,102,3080156,2020-04-05,1.0139665306659,0.0323734598468766
Nevada,2020-04-12,134,10,2836,112,3080156,2020-04-06,1.02332363594554,0.0323280228557406
Nevada,2020-04-13,154,2,2990,114,3080156,2020-04-07,1.08576167250219,0.033380410494728
Nevada,2020-04-14,144,12,3134,126,3080156,2020-04-08,1.04400348245234,0.0325141657014823
Nevada,2020-04-15,77,5,3211,131,3080156,2020-04-09,0.976232437132863,0.0312965750978845
Nevada,2020-04-16,3,6,3214,137,3080156,2020-04-10,0.786281844128957,0.0281714706151421
Nevada,2020-04-17,310,5,3524,142,3080156,2020-04-11,0.868080528793568,0.0302593850251901
Nevada,2020-04-18,102,9,3626,151,3080156,2020-04-12,1.01189378710376,0.0332708627720881
Nevada,2020-04-19,102,7,3728,158,3080156,2020-04-13,0.976539934567875,0.0326786629142159
Nevada,2020-04-20,102,1,3830,159,3080156,2020-04-14,0.919678397842274,0.0317130482014577
Nevada,2020-04-21,107,4,3937,163,3080156,2020-04-15,0.89285858894263,0.0314886945646189
Nevada,2020-04-22,144,9,4081,172,3080156,2020-04-16,0.989591221613829,0.0335310193775793
Nevada,2020-04-23,127,23,4208,195,3080156,2020-04-17,1.13598774911087,0.0360132327177649
Nevada,2020-04-24,190,2,4398,197,3080156,2020-04-18,0.972058738483661,0.03286158314702
Nevada,2020-04-25,141,8,4539,205,3080156,2020-04-19,1.01308770883142,0.0335099630141439
Nevada,2020-04-26,195,1,4734,206,3080156,2020-04-20,1.11802552288114,0.0352319744782236
Nevada,2020-04-27,-34,0,4700,206,3080156,2020-04-21,0.982517791242868,0.0326599964832504
Nevada,2020-04-28,121,13,4821,219,3080156,2020-04-22,0.995936048488594,0.0328528988470432
Nevada,2020-04-29,113,11,4934,230,3080156,2020-04-23,0.9668205054085,0.0324443718254999
Nevada,2020-04-30,119,13,5053,243,3080156,2020-04-24,0.964467070833225,0.0325121783253043
Nevada,2020-05-01,195,3,5248,246,3080156,2020-04-25,0.978316938832852,0.0328857641449619
Nevada,2020-05-02,141,9,5389,255,3080156,2020-04-26,0.983438118000322,0.0330579106994787
Nevada,2020-05-03,83,3,5472,258,3080156,2020-04-27,0.861846855215063,0.0309984768194857
Nevada,2020-05-04,158,7,5630,265,3080156,2020-04-28,1.06527407798463,0.0349129477677329
Nevada,2020-05-05,30,5,5660,270,3080156,2020-04-29,0.955728585778854,0.0329757690562481
Nevada,2020-05-06,81,19,5741,289,3080156,2020-04-30,0.920667886434673,0.0323889832203731
Nevada,2020-05-07,114,8,5855,297,3080156,2020-05-01,0.931438367377645,0.0328697461881688
Nevada,2020-05-08,65,-3,5920,294,3080156,2020-05-02,0.792715377109567,0.0305569322029424
Nevada,2020-05-09,251,19,6171,313,3080156,2020-05-03,0.959964559998465,0.0343063345924801
Nevada,2020-05-10,-51,-3,6120,310,3080156,2020-05-04,0.871680766154513,0.032946436141187
New Hampshire,2020-03-08,2,0,4,0,1359711,2020-03-02,3.09587030708209,1.38451529123174
New Hampshire,2020-03-09,0,0,4,0,1359711,2020-03-03,1.91640260940956,0.958201304704778
New Hampshire,2020-03-10,0,0,4,0,1359711,2020-03-04,1.25838906177808,0.726531263562852
New Hampshire,2020-03-11,1,0,5,0,1359711,2020-03-05,1.7189425857317,0.859471292865851
New Hampshire,2020-03-12,1,0,6,0,1359711,2020-03-06,2.05717702987979,0.919997536112466
New Hampshire,2020-03-13,0,0,6,0,1359711,2020-03-07,1.79724378286247,0.80375185412387
New Hampshire,2020-03-14,1,0,7,0,1359711,2020-03-08,1.93937536077186,0.791746675602849
New Hampshire,2020-03-15,0,0,7,0,1359711,2020-03-09,1.14499581758398,0.572497908791991
New Hampshire,2020-03-16,10,0,17,0,1359711,2020-03-10,4.0123763917941,1.07235269749098
New Hampshire,2020-03-17,9,0,26,0,1359711,2020-03-11,4.43281310890262,0.924305428027349
New Hampshire,2020-03-18,11,0,37,0,1359711,2020-03-12,3.7646754722794,0.655345881648307
New Hampshire,2020-03-19,5,0,42,0,1359711,2020-03-13,2.71363961843229,0.446119605181965
New Hampshire,2020-03-20,11,0,53,0,1359711,2020-03-14,2.60388324039606,0.375838172445255
New Hampshire,2020-03-21,8,0,61,0,1359711,2020-03-15,2.2815922783537,0.307649840052652
New Hampshire,2020-03-22,12,0,73,0,1359711,2020-03-16,2.21357438473202,0.270431152624061
New Hampshire,2020-03-23,28,1,101,1,1359711,2020-03-17,2.27473027467615,0.246729139949727
New Hampshire,2020-03-24,0,0,101,1,1359711,2020-03-18,1.62876870182494,0.186832583517285
New Hampshire,2020-03-25,7,0,108,1,1359711,2020-03-19,1.36036102144857,0.160320083854691
New Hampshire,2020-03-26,29,0,137,1,1359711,2020-03-20,1.71119054651323,0.174647653817987
New Hampshire,2020-03-27,21,0,158,1,1359711,2020-03-21,1.68339313802033,0.163505595574838
New Hampshire,2020-03-28,29,1,187,2,1359711,2020-03-22,1.7716619551245,0.157209576836461
New Hampshire,2020-03-29,27,0,214,2,1359711,2020-03-23,1.7239954972362,0.144674488306805
New Hampshire,2020-03-30,100,1,314,3,1359711,2020-03-24,2.26915925564592,0.155116533333731
New Hampshire,2020-03-31,43,0,357,3,1359711,2020-03-25,2.19426057338147,0.13687421394542
New Hampshire,2020-04-01,10,0,367,3,1359711,2020-03-26,1.7767331554085,0.11018831268347
New Hampshire,2020-04-02,112,0,479,3,1359711,2020-03-27,2.01606634655491,0.108857350603895
New Hampshire,2020-04-03,0,2,479,5,1359711,2020-03-28,1.58842686497427,0.0885195684119535
New Hampshire,2020-04-04,61,2,540,7,1359711,2020-03-29,1.54852602791901,0.0823032298029435
New Hampshire,2020-04-05,81,2,621,9,1359711,2020-03-30,1.62240995391839,0.0803212614786595
New Hampshire,2020-04-06,94,0,715,9,1359711,2020-03-31,1.42871427743616,0.0712577915186419
New Hampshire,2020-04-07,0,0,715,9,1359711,2020-04-01,1.17316303587214,0.0619171768828209
New Hampshire,2020-04-08,32,4,747,13,1359711,2020-04-02,1.20666918557665,0.0618195350768137
New Hampshire,2020-04-09,72,8,819,21,1359711,2020-04-03,1.04855320382517,0.0567823395072621
New Hampshire,2020-04-10,0,0,819,21,1359711,2020-04-04,1.03998545625706,0.0563183699638472
New Hampshire,2020-04-11,66,1,885,22,1359711,2020-04-05,1.05564482730603,0.0567518175059212
New Hampshire,2020-04-12,44,1,929,23,1359711,2020-04-06,0.936701538201935,0.0532870887192605
New Hampshire,2020-04-13,56,0,985,23,1359711,2020-04-07,0.832668016373503,0.0505809798088016
New Hampshire,2020-04-14,-63,2,922,25,1359711,2020-04-08,0.865466018380244,0.0525733165440315
New Hampshire,2020-04-15,217,7,1139,32,1359711,2020-04-09,1.50721853267784,0.0705819746329523
New Hampshire,2020-04-16,0,0,1139,32,1359711,2020-04-10,1.16512163457273,0.0594573644370972
New Hampshire,2020-04-17,148,5,1287,37,1359711,2020-04-11,1.52926786813206,0.0663021707265104
New Hampshire,2020-04-18,55,1,1342,38,1359711,2020-04-12,1.36888756149645,0.0599720529286386
New Hampshire,2020-04-19,48,0,1390,38,1359711,2020-04-13,1.27062029357373,0.0554544159509394
New Hampshire,2020-04-20,57,4,1447,42,1359711,2020-04-14,1.20909993665522,0.0527192625170494
New Hampshire,2020-04-21,43,0,1490,42,1359711,2020-04-15,1.25834752199202,0.0527526723450967
New Hampshire,2020-04-22,98,6,1588,48,1359711,2020-04-16,0.950389006093692,0.0448017673982662
New Hampshire,2020-04-23,82,3,1670,51,1359711,2020-04-17,1.13000309344069,0.0489918473957761
New Hampshire,2020-04-24,50,2,1720,53,1359711,2020-04-18,0.911042495814344,0.043731439227535
New Hampshire,2020-04-25,77,0,1797,53,1359711,2020-04-19,0.969351208867703,0.0453940294332527
New Hampshire,2020-04-26,67,7,1864,60,1359711,2020-04-20,1.02568638582961,0.0470617189852286
New Hampshire,2020-04-27,74,0,1938,60,1359711,2020-04-21,1.0589455288362,0.0477409514059225
New Hampshire,2020-04-28,72,0,2010,60,1359711,2020-04-22,1.10857573536102,0.0485675847648118
New Hampshire,2020-04-29,48,0,2058,60,1359711,2020-04-23,0.981219853464966,0.0452122242839283
New Hampshire,2020-04-30,88,12,2146,72,1359711,2020-04-24,0.99422618439476,0.0455224897936725
New Hampshire,2020-05-01,164,9,2310,81,1359711,2020-04-25,1.23868631900221,0.0509527467113754
New Hampshire,2020-05-02,119,3,2429,84,1359711,2020-04-26,1.27231410746768,0.0505699457426948
New Hampshire,2020-05-03,89,2,2518,86,1359711,2020-04-27,1.24168895580174,0.048516802204207
New Hampshire,2020-05-04,70,0,2588,86,1359711,2020-04-28,1.17442512107942,0.0460293495667686
New Hampshire,2020-05-05,48,6,2636,92,1359711,2020-04-29,1.09220381569497,0.0436184188999826
New Hampshire,2020-05-06,105,0,2741,92,1359711,2020-04-30,1.1711897258882,0.0447815584110505
New Hampshire,2020-05-07,102,22,2843,114,1359711,2020-05-01,1.16135346128001,0.0439578767830163
New Hampshire,2020-05-08,104,7,2947,121,1359711,2020-05-02,1.02769554268101,0.04068685615801
New Hampshire,2020-05-09,64,10,3011,131,1359711,2020-05-03,0.933043221629643,0.0386427019071445
New Hampshire,2020-05-10,60,2,3071,133,1359711,2020-05-04,0.901992921886044,0.0383220071170742
New Jersey,2020-03-08,1,0,5,0,8882190,2020-03-02,3.78020470644025,1.54326210900768
New Jersey,2020-03-09,0,0,5,0,8882190,2020-03-03,2.54551836168731,1.03920351950322
New Jersey,2020-03-10,10,1,15,1,8882190,2020-03-04,5.40821099980395,1.35205274995099
New Jersey,2020-03-11,8,0,23,1,8882190,2020-03-05,4.58887962349242,0.936701130717618
New Jersey,2020-03-12,6,0,29,1,8882190,2020-03-06,3.10575410435109,0.586932356673653
New Jersey,2020-03-13,20,0,49,1,8882190,2020-03-07,3.72627859182977,0.537841987017114
New Jersey,2020-03-14,20,0,69,1,8882190,2020-03-08,3.37835032055199,0.415846178007252
New Jersey,2020-03-15,3,1,72,2,8882190,2020-03-09,2.3460900418369,0.284505207344214
New Jersey,2020-03-16,104,0,176,2,8882190,2020-03-10,4.6273828654166,0.352834635678811
New Jersey,2020-03-17,74,1,250,3,8882190,2020-03-11,3.79301420786577,0.246904194528418
New Jersey,2020-03-18,147,2,397,5,8882190,2020-03-12,3.78446588867506,0.195428978148381
New Jersey,2020-03-19,344,4,741,9,8882190,2020-03-13,4.62454506932055,0.173190573912826
New Jersey,2020-03-20,149,2,890,11,8882190,2020-03-14,3.18067827235646,0.10961341197954
New Jersey,2020-03-21,437,5,1327,16,8882190,2020-03-15,3.23485298240173,0.0911678436132895
New Jersey,2020-03-22,587,4,1914,20,8882190,2020-03-16,3.28815439025772,0.0765930798983731
New Jersey,2020-03-23,930,7,2844,27,8882190,2020-03-17,3.25749904029466,0.0630536177407673
New Jersey,2020-03-24,831,17,3675,44,8882190,2020-03-18,2.87045558235981,0.0490407554466224
New Jersey,2020-03-25,727,18,4402,62,8882190,2020-03-19,2.42357608723307,0.038291394807157
New Jersey,2020-03-26,2474,19,6876,81,8882190,2020-03-20,2.87352258566585,0.0366835991811145
New Jersey,2020-03-27,1949,27,8825,108,8882190,2020-03-21,2.72552876248428,0.0305949635355407
New Jersey,2020-03-28,2299,32,11124,140,8882190,2020-03-22,2.48233054880657,0.0250778843013252
New Jersey,2020-03-29,2262,21,13386,161,8882190,2020-03-23,2.23263104703536,0.0208438751398374
New Jersey,2020-03-30,3250,37,16636,198,8882190,2020-03-24,2.14726388360932,0.0182833617145263
New Jersey,2020-03-31,2060,69,18696,267,8882190,2020-03-25,1.9041984098429,0.0155363257793605
New Jersey,2020-04-01,3559,88,22255,355,8882190,2020-03-26,1.91225197837548,0.0143112429253188
New Jersey,2020-04-02,3335,182,25590,537,8882190,2020-03-27,1.7026903138414,0.012446313896917
New Jersey,2020-04-03,4305,109,29895,646,8882190,2020-03-28,1.677468194513,0.0115561114321775
New Jersey,2020-04-04,4229,200,34124,846,8882190,2020-03-29,1.62025436535335,0.0106834086589929
New Jersey,2020-04-05,3381,71,37505,917,8882190,2020-03-30,1.51396799319869,0.00974828105872622
New Jersey,2020-04-06,3585,86,41090,1003,8882190,2020-03-31,1.39388935419738,0.00891342198393526
New Jersey,2020-04-07,3326,229,44416,1232,8882190,2020-04-01,1.36235336065033,0.00849465690652289
New Jersey,2020-04-08,3021,272,47437,1504,8882190,2020-04-02,1.24976080288673,0.00787540989058776
New Jersey,2020-04-09,3590,205,51027,1709,8882190,2020-04-03,1.20470722539587,0.00755335738310711
New Jersey,2020-04-10,3561,223,54588,1932,8882190,2020-04-04,1.1291033172251,0.00718518511330961
New Jersey,2020-04-11,3563,251,58151,2183,8882190,2020-04-05,1.07436374991117,0.00693094631181243
New Jersey,2020-04-12,3699,167,61850,2350,8882190,2020-04-06,1.07715298487716,0.00690340861862666
New Jersey,2020-04-13,2734,93,64584,2443,8882190,2020-04-07,1.02837493036651,0.00670909213819928
New Jersey,2020-04-14,4240,362,68824,2805,8882190,2020-04-08,1.06419676102064,0.0068115655302607
New Jersey,2020-04-15,2206,351,71030,3156,8882190,2020-04-09,1.01969618955014,0.0066385007532989
New Jersey,2020-04-16,4287,362,75317,3518,8882190,2020-04-10,1.04568719926102,0.00670932909432096
New Jersey,2020-04-17,3150,322,78467,3840,8882190,2020-04-11,1.02163817211702,0.00661119474275072
New Jersey,2020-04-18,2953,230,81420,4070,8882190,2020-04-12,0.99125757181811,0.00649812896176487
New Jersey,2020-04-19,3881,292,85301,4362,8882190,2020-04-13,1.00176359626924,0.00654146922840266
New Jersey,2020-04-20,3421,134,88722,4496,8882190,2020-04-14,1.032740827786,0.00664709229717253
New Jersey,2020-04-21,3665,257,92387,4753,8882190,2020-04-15,1.00259882784062,0.00653134591356813
New Jersey,2020-04-22,3527,397,95914,5150,8882190,2020-04-16,1.05723112600033,0.00670194899299889
New Jersey,2020-04-23,4111,276,100025,5426,8882190,2020-04-17,1.03990445293042,0.00661554843141399
New Jersey,2020-04-24,2171,257,102196,5683,8882190,2020-04-18,0.989229193271124,0.00642167105322908
New Jersey,2020-04-25,3302,231,105498,5914,8882190,2020-04-19,1.00557948596462,0.00648033088856604
New Jersey,2020-04-26,3540,24,109038,5938,8882190,2020-04-20,0.992288005499286,0.00644044208155153
New Jersey,2020-04-27,2150,106,111188,6044,8882190,2020-04-21,0.940505939606608,0.00627464269043715
New Jersey,2020-04-28,2668,398,113856,6442,8882190,2020-04-22,0.90947642953663,0.00620690968202194
New Jersey,2020-04-29,2509,329,116365,6771,8882190,2020-04-23,0.883648768810351,0.00617890879341764
New Jersey,2020-04-30,2287,457,118652,7228,8882190,2020-04-24,0.825007021763897,0.00604469691981872
New Jersey,2020-05-01,2538,310,121190,7538,8882190,2020-04-25,0.872099518575662,0.00632770753246962
New Jersey,2020-05-02,2527,204,123717,7742,8882190,2020-04-26,0.861117901594356,0.0063795262894373
New Jersey,2020-05-03,3027,129,126744,7871,8882190,2020-04-27,0.859404842774368,0.00645840540560341
New Jersey,2020-05-04,1525,39,128269,7910,8882190,2020-04-28,0.852734955750517,0.00652446202053979
New Jersey,2020-05-05,2324,334,130593,8244,8882190,2020-04-29,0.860166415918573,0.00664860757890944
New Jersey,2020-05-06,1297,305,131890,8549,8882190,2020-04-30,0.820354061518104,0.00658372286913323
New Jersey,2020-05-07,2101,258,133991,8807,8882190,2020-05-01,0.839082174984884,0.00677472725352628
New Jersey,2020-05-08,1849,153,135840,8960,8882190,2020-05-02,0.828450850204128,0.00684436424390249
New Jersey,2020-05-09,1557,156,137397,9116,8882190,2020-05-03,0.799612691924228,0.00683629440639438
New Jersey,2020-05-10,1357,140,138754,9256,8882190,2020-05-04,0.730198143050609,0.00666271352908158
New Mexico,2020-03-08,0,0,0,0,2096829,2020-03-02,5,5
New Mexico,2020-03-09,0,0,0,0,2096829,2020-03-03,5,5
New Mexico,2020-03-10,0,0,0,0,2096829,2020-03-04,5,5
New Mexico,2020-03-11,3,0,3,0,2096829,2020-03-05,20,10
New Mexico,2020-03-12,2,0,5,0,2096829,2020-03-06,7.98806896452533,3.26111549887491
New Mexico,2020-03-13,5,0,10,0,2096829,2020-03-07,6.42265607804758,1.93650366985267
New Mexico,2020-03-14,3,0,13,0,2096829,2020-03-08,4.1034627778272,1.0966965581435
New Mexico,2020-03-15,0,0,13,0,2096829,2020-03-09,2.54800085987417,0.680981874203895
New Mexico,2020-03-16,8,0,21,0,2096829,2020-03-10,3.08123381475613,0.656921256565137
New Mexico,2020-03-17,2,0,23,0,2096829,2020-03-11,2.45130023305439,0.500369564779062
New Mexico,2020-03-18,5,0,28,0,2096829,2020-03-12,2.05510548585552,0.403039345187264
New Mexico,2020-03-19,7,0,35,0,2096829,2020-03-13,2.04514449874204,0.367318795384961
New Mexico,2020-03-20,7,0,42,0,2096829,2020-03-14,1.82680709158628,0.318006296386586
New Mexico,2020-03-21,13,0,55,0,2096829,2020-03-15,2.05524382048493,0.313421744308873
New Mexico,2020-03-22,2,0,57,0,2096829,2020-03-16,1.80160514163022,0.268567437686554
New Mexico,2020-03-23,26,0,83,0,2096829,2020-03-17,2.17209322389434,0.273658023565379
New Mexico,2020-03-24,17,0,100,0,2096829,2020-03-18,2.20879796759655,0.250097121177483
New Mexico,2020-03-25,13,1,113,1,2096829,2020-03-19,1.95882216033916,0.211225225761722
New Mexico,2020-03-26,0,0,113,1,2096829,2020-03-20,1.5065216354658,0.169496926454586
New Mexico,2020-03-27,23,0,136,1,2096829,2020-03-21,1.64352345389767,0.168621948484324
New Mexico,2020-03-28,72,0,208,1,2096829,2020-03-22,2.39539039319101,0.19302605866391
New Mexico,2020-03-29,29,1,237,2,2096829,2020-03-23,2.22749289734949,0.165568243140702
New Mexico,2020-03-30,0,0,237,2,2096829,2020-03-24,1.51420864344371,0.121624165040522
New Mexico,2020-03-31,78,2,315,4,2096829,2020-03-25,1.89499839499414,0.12893830919802
New Mexico,2020-04-01,12,1,327,5,2096829,2020-03-26,1.63005097649964,0.111168553902107
New Mexico,2020-04-02,46,1,373,6,2096829,2020-03-27,1.74436136430965,0.107973257816154
New Mexico,2020-04-03,117,4,490,10,2096829,2020-03-28,2.08234436310845,0.110519363500911
New Mexico,2020-04-04,16,1,506,11,2096829,2020-03-29,1.44830624117747,0.0837577125332832
New Mexico,2020-04-05,118,1,624,12,2096829,2020-03-30,1.69967661713555,0.0862880067587933
New Mexico,2020-04-06,62,0,686,12,2096829,2020-03-31,1.75728762331791,0.0828393329962192
New Mexico,2020-04-07,108,1,794,13,2096829,2020-04-01,1.62599595501113,0.0742162219143124
New Mexico,2020-04-08,27,0,821,13,2096829,2020-04-02,1.48770446570352,0.0668673430775511
New Mexico,2020-04-09,44,3,865,16,2096829,2020-04-03,1.35194845496168,0.0608886961280417
New Mexico,2020-04-10,216,1,1081,17,2096829,2020-04-04,1.52124099340727,0.0625226196908878
New Mexico,2020-04-11,10,2,1091,19,2096829,2020-04-05,1.37532996825537,0.056814357316067
New Mexico,2020-04-12,154,7,1245,26,2096829,2020-04-06,1.35353942070579,0.0542719862748689
New Mexico,2020-04-13,17,0,1262,26,2096829,2020-04-07,1.1782279823828,0.0490502727017302
New Mexico,2020-04-14,83,5,1345,31,2096829,2020-04-08,1.08865704570341,0.0463363209955778
New Mexico,2020-04-15,139,5,1484,36,2096829,2020-04-09,1.29457611652308,0.0502392966703127
New Mexico,2020-04-16,0,0,1484,36,2096829,2020-04-10,1.15215774477218,0.0462717685272864
New Mexico,2020-04-17,113,8,1597,44,2096829,2020-04-11,0.927995705178256,0.0408132044479484
New Mexico,2020-04-18,201,9,1798,53,2096829,2020-04-12,1.29146206971444,0.0485361167508585
New Mexico,2020-04-19,47,2,1845,55,2096829,2020-04-13,1.05124976439382,0.0428813723164717
New Mexico,2020-04-20,126,3,1971,58,2096829,2020-04-14,1.21584139905676,0.0456297146151448
New Mexico,2020-04-21,0,0,1971,58,2096829,2020-04-15,1.0389523700252,0.0414917610080439
New Mexico,2020-04-22,239,13,2210,71,2096829,2020-04-16,1.18854411635686,0.0440806612868529
New Mexico,2020-04-23,169,7,2379,78,2096829,2020-04-17,1.42317336561341,0.0475448851438157
New Mexico,2020-04-24,142,6,2521,84,2096829,2020-04-18,1.35628101973126,0.0445942452290592
New Mexico,2020-04-25,139,9,2660,93,2096829,2020-04-19,1.17352118665573,0.0399471257655562
New Mexico,2020-04-26,66,6,2726,99,2096829,2020-04-20,1.15662282873821,0.0389455164512359
New Mexico,2020-04-27,99,0,2825,99,2096829,2020-04-21,1.09282039594062,0.0373736689650734
New Mexico,2020-04-28,149,6,2974,105,2096829,2020-04-22,1.26207503802444,0.0398307350145238
New Mexico,2020-04-29,239,7,3213,112,2096829,2020-04-23,1.20701102200915,0.0380929300784768
New Mexico,2020-04-30,198,11,3411,123,2096829,2020-04-24,1.18819782477174,0.0369690756772481
New Mexico,2020-05-01,102,8,3513,131,2096829,2020-04-25,1.10255622010252,0.0349885640716699
New Mexico,2020-05-02,219,7,3732,138,2096829,2020-04-26,1.16769371358307,0.0356475002847752
New Mexico,2020-05-03,118,13,3850,151,2096829,2020-04-27,1.19032481810915,0.0354886294479618
New Mexico,2020-05-04,181,5,4031,156,2096829,2020-04-28,1.23064269588761,0.0354224293987342
New Mexico,2020-05-05,107,6,4138,162,2096829,2020-04-29,1.13658831662186,0.0332996926287393
New Mexico,2020-05-06,153,7,4291,169,2096829,2020-04-30,1.02282268635876,0.0311379222458537
New Mexico,2020-05-07,202,3,4493,172,2096829,2020-05-01,1.02357392815874,0.0311031938398913
New Mexico,2020-05-08,180,9,4673,181,2096829,2020-05-02,1.09781035580279,0.0322189374246741
New Mexico,2020-05-09,105,10,4778,191,2096829,2020-05-03,0.974373137121083,0.0301128569726549
New Mexico,2020-05-10,85,9,4863,200,2096829,2020-05-04,0.945978240900823,0.0297072307433672
New York,2020-03-08,30,0,106,0,23628065,2020-03-02,4.36750567643423,0.422222710352304
New York,2020-03-09,36,0,142,0,23628065,2020-03-03,3.39269895800586,0.284708971987112
New York,2020-03-10,8,0,150,0,23628065,2020-03-04,2.39386247766491,0.196112855503589
New York,2020-03-11,70,0,220,0,23628065,2020-03-05,2.61340435009967,0.180342033463927
New York,2020-03-12,107,1,327,1,23628065,2020-03-06,2.90442842778135,0.166307087988145
New York,2020-03-13,94,1,421,2,23628065,2020-03-07,2.70141026393563,0.136616189217302
New York,2020-03-14,192,4,613,6,23628065,2020-03-08,2.75634498872718,0.118834470617085
New York,2020-03-15,2,6,615,12,23628065,2020-03-09,1.93470350042458,0.085670110954127
New York,2020-03-16,352,12,967,24,23628065,2020-03-10,2.60326999420715,0.0905793477331441
New York,2020-03-17,611,14,1578,38,23628065,2020-03-11,3.47213192354161,0.0918501993922454
New York,2020-03-18,1460,25,3038,63,23628065,2020-03-12,4.59530555027696,0.08654995686795
New York,2020-03-19,2666,33,5704,96,23628065,2020-03-13,5.11486667967206,0.0697467409620476
New York,2020-03-20,2699,55,8403,151,23628065,2020-03-14,4.15252075861501,0.0464760004831581
New York,2020-03-21,3324,44,11727,195,23628065,2020-03-15,3.4938113867147,0.0331394062024223
New York,2020-03-22,4073,91,15800,286,23628065,2020-03-16,3.15881311856564,0.0256331651255589
New York,2020-03-23,5084,101,20884,387,23628065,2020-03-17,2.88055846071067,0.0204105087303521
New York,2020-03-24,4797,125,25681,512,23628065,2020-03-18,2.52230844268441,0.0162462687896842
New York,2020-03-25,5160,147,30841,659,23628065,2020-03-19,2.21966613249804,0.0133117151475577
New York,2020-03-26,7036,243,37877,902,23628065,2020-03-20,2.06060639643674,0.0114879494228979
New York,2020-03-27,6999,309,44876,1211,23628065,2020-03-21,1.92942005430922,0.0101026449748315
New York,2020-03-28,7534,377,52410,1588,23628065,2020-03-22,1.81658231955711,0.00900623469543355
New York,2020-03-29,7238,428,59648,2016,23628065,2020-03-23,1.68554113874699,0.00804932587396058
New York,2020-03-30,7015,540,66663,2556,23628065,2020-03-24,1.54978415883519,0.00724324746773918
New York,2020-03-31,9170,651,75833,3207,23628065,2020-03-25,1.53311019864744,0.00684581115172928
New York,2020-04-01,8115,710,83948,3917,23628065,2020-03-26,1.47417417177953,0.00639688914392773
New York,2020-04-02,8558,813,92506,4730,23628065,2020-03-27,1.38794496024722,0.00593822493120799
New York,2020-04-03,10481,688,102987,5418,23628065,2020-03-28,1.37325792041388,0.00569664559136246
New York,2020-04-04,10846,573,113833,5991,23628065,2020-03-29,1.35630848800691,0.00547254614497931
New York,2020-04-05,9327,794,123160,6785,23628065,2020-03-30,1.31256298672255,0.0052082142309205
New York,2020-04-06,8655,1024,131815,7809,23628065,2020-03-31,1.2696932780355,0.00497429584742997
New York,2020-04-07,8060,1077,139875,8886,23628065,2020-04-01,1.18709952800648,0.00469084733034067
New York,2020-04-08,11186,948,151061,9834,23628065,2020-04-02,1.20149458457515,0.00463783459613303
New York,2020-04-09,10718,944,161779,10778,23628065,2020-04-03,1.19773753765131,0.00455068241805593
New York,2020-04-10,10569,827,172348,11605,23628065,2020-04-04,1.15590150147928,0.00438894384535179
New York,2020-04-11,8678,893,181026,12498,23628065,2020-04-05,1.08732379163247,0.00419462985300076
New York,2020-04-12,8007,944,189033,13442,23628065,2020-04-06,1.04947505299653,0.00408898108635021
New York,2020-04-13,6716,948,195749,14390,23628065,2020-04-07,1.01187585734738,0.00400182321528751
New York,2020-04-14,7271,871,203020,15261,23628065,2020-04-08,0.999638989258289,0.00397805024392051
New York,2020-04-15,11434,752,214454,16013,23628065,2020-04-09,1.00653384732801,0.00399764574418394
New York,2020-04-16,9237,716,223691,16729,23628065,2020-04-10,0.983873435313186,0.00395410602790503
New York,2020-04-17,6906,1026,230597,17755,23628065,2020-04-11,0.929289078145592,0.00385037357478719
New York,2020-04-18,6877,1005,237474,18760,23628065,2020-04-12,0.914086834995816,0.00384732901459679
New York,2020-04-19,5908,-178,243382,18582,23628065,2020-04-13,0.897585233584218,0.00385013471024063
New York,2020-04-20,5034,594,248416,19176,23628065,2020-04-14,0.889037399405239,0.00387388404895746
New York,2020-04-21,5103,570,253519,19746,23628065,2020-04-15,0.872657147559673,0.00388327333901244
New York,2020-04-22,4703,457,258222,20203,23628065,2020-04-16,0.776337845240986,0.00371079912650455
New York,2020-04-23,5238,540,263460,20743,23628065,2020-04-17,0.737628233105211,0.00369879051878225
New York,2020-04-24,8130,212,271590,20955,23628065,2020-04-18,0.804534124405122,0.0039736015929216
New York,2020-04-25,10553,1054,282143,22009,23628065,2020-04-19,0.914812170854145,0.0043283658081976
New York,2020-04-26,5902,260,288045,22269,23628065,2020-04-20,0.929643846488268,0.0043988362114404
New York,2020-04-27,3951,399,291996,22668,23628065,2020-04-21,0.915375597051321,0.00438480954838835
New York,2020-04-28,3110,244,295106,22912,23628065,2020-04-22,0.885748059135377,0.00434336364345675
New York,2020-04-29,4585,565,299691,23477,23628065,2020-04-23,0.902096385998849,0.00442981842585478
New York,2020-04-30,4681,110,304372,23587,23628065,2020-04-24,0.907655030988596,0.00448735218782072
New York,2020-05-01,3942,452,308314,24039,23628065,2020-04-25,0.828892139826966,0.00432530880301524
New York,2020-05-02,4663,159,312977,24198,23628065,2020-04-26,0.718702396631504,0.00409286214157474
New York,2020-05-03,3438,510,316415,24708,23628065,2020-04-27,0.70050283058283,0.00415884344974277
New York,2020-05-04,2538,291,318953,24999,23628065,2020-04-28,0.710341974248596,0.0043263698510375
New York,2020-05-05,2239,125,321192,25124,23628065,2020-04-29,0.730116862974503,0.00452043584522067
New York,2020-05-06,2786,499,323978,25623,23628065,2020-04-30,0.717641416842285,0.00460480896577763
New York,2020-05-07,3491,521,327469,26144,23628065,2020-05-01,0.721059952959298,0.0047444315732658
New York,2020-05-08,2938,99,330407,26243,23628065,2020-05-02,0.728808853127733,0.0049031645083509
New York,2020-05-09,2715,369,333122,26612,23628065,2020-05-03,0.700630006363558,0.00493621785277077
New York,2020-05-10,2273,29,335395,26641,23628065,2020-05-04,0.699397502527253,0.00507650166040818
North Carolina,2020-03-08,0,0,2,0,10488084,2020-03-02,2.38055547260991,1.37441434293217
North Carolina,2020-03-09,0,0,2,0,10488084,2020-03-03,2.07396649006826,1.19740511133117
North Carolina,2020-03-10,5,0,7,0,10488084,2020-03-04,4.40761987025276,1.66592372148508
North Carolina,2020-03-11,0,0,7,0,10488084,2020-03-05,2.87563796351065,1.08688898744363
North Carolina,2020-03-12,8,0,15,0,10488084,2020-03-06,4.52441585548081,1.1681991506396
North Carolina,2020-03-13,2,0,17,0,10488084,2020-03-07,2.97985917562325,0.744964793905813
North Carolina,2020-03-14,8,0,25,0,10488084,2020-03-08,3.16787311644436,0.64663939209742
North Carolina,2020-03-15,7,0,32,0,10488084,2020-03-09,2.92154242399017,0.524724509444791
North Carolina,2020-03-16,7,0,39,0,10488084,2020-03-10,2.5953640952062,0.421023651876106
North Carolina,2020-03-17,25,0,64,0,10488084,2020-03-11,3.01438408331439,0.395808021249137
North Carolina,2020-03-18,28,0,92,0,10488084,2020-03-12,3.22395619974441,0.347648137704858
North Carolina,2020-03-19,44,0,136,0,10488084,2020-03-13,3.16826501757308,0.286841237026392
North Carolina,2020-03-20,53,0,189,0,10488084,2020-03-14,3.12605053541019,0.237669221125
North Carolina,2020-03-21,67,0,256,0,10488084,2020-03-15,2.93650361571698,0.192790907429737
North Carolina,2020-03-22,49,0,305,0,10488084,2020-03-16,2.49005039151876,0.150429445502194
North Carolina,2020-03-23,48,0,353,0,10488084,2020-03-17,2.19189562310724,0.12349932745266
North Carolina,2020-03-24,142,0,495,0,10488084,2020-03-18,2.42601389304595,0.116721647850654
North Carolina,2020-03-25,95,2,590,2,10488084,2020-03-19,2.19524522154017,0.0982726727111534
North Carolina,2020-03-26,148,1,738,3,10488084,2020-03-20,2.12853875860129,0.0866807991430598
North Carolina,2020-03-27,149,1,887,4,10488084,2020-03-21,2.01629102395165,0.0762631305635892
North Carolina,2020-03-28,133,1,1020,5,10488084,2020-03-22,1.83283764116626,0.0662663847675772
North Carolina,2020-03-29,171,2,1191,7,10488084,2020-03-23,1.82087741670143,0.0611390800559993
North Carolina,2020-03-30,122,0,1313,7,10488084,2020-03-24,1.70114617907131,0.0548756831958488
North Carolina,2020-03-31,222,5,1535,12,10488084,2020-03-25,1.61617958067873,0.0500915246569909
North Carolina,2020-04-01,140,2,1675,14,10488084,2020-03-26,1.50487190861034,0.0456651220450071
North Carolina,2020-04-02,302,7,1977,21,10488084,2020-03-27,1.56386594916246,0.0444108086501418
North Carolina,2020-04-03,274,6,2251,27,10488084,2020-03-28,1.55562994096059,0.0421056104012553
North Carolina,2020-04-04,235,7,2486,34,10488084,2020-03-29,1.50612141894402,0.0393228446779531
North Carolina,2020-04-05,163,4,2649,38,10488084,2020-03-30,1.36163849406544,0.0356479183680601
North Carolina,2020-04-06,313,7,2962,45,10488084,2020-03-31,1.43664618963689,0.0353677842984363
North Carolina,2020-04-07,337,8,3299,53,10488084,2020-04-01,1.42251626220012,0.0338598387141344
North Carolina,2020-04-08,200,13,3499,66,10488084,2020-04-02,1.35694993613799,0.0317637954426613
North Carolina,2020-04-09,237,10,3736,76,10488084,2020-04-03,1.22262586968823,0.0291432006847896
North Carolina,2020-04-10,229,7,3965,83,10488084,2020-04-04,1.14194144784929,0.027574762094305
North Carolina,2020-04-11,389,6,4354,89,10488084,2020-04-05,1.21566500261747,0.0281196080839612
North Carolina,2020-04-12,216,0,4570,89,10488084,2020-04-06,1.20613583190938,0.0275118330895227
North Carolina,2020-04-13,316,5,4886,94,10488084,2020-04-07,1.1609547435682,0.0264606143641166
North Carolina,2020-04-14,227,18,5113,112,10488084,2020-04-08,1.06178650461108,0.0249229178762817
North Carolina,2020-04-15,227,18,5340,130,10488084,2020-04-09,1.06579224730491,0.0248329173946094
North Carolina,2020-04-16,299,20,5639,150,10488084,2020-04-10,1.09271133794848,0.0250421710295764
North Carolina,2020-04-17,406,27,6045,177,10488084,2020-04-11,1.17563778982424,0.0257713694878186
North Carolina,2020-04-18,283,10,6328,187,10488084,2020-04-12,1.08024737749786,0.0243074650885981
North Carolina,2020-04-19,273,13,6601,200,10488084,2020-04-13,1.09071016897275,0.024196219208108
North Carolina,2020-04-20,294,18,6895,218,10488084,2020-04-14,1.06325611423752,0.0237159136327184
North Carolina,2020-04-21,239,27,7134,245,10488084,2020-04-15,1.05681753171386,0.0235022495644228
North Carolina,2020-04-22,361,20,7495,265,10488084,2020-04-16,1.11620895840246,0.024039261705548
North Carolina,2020-04-23,325,16,7820,281,10488084,2020-04-17,1.10649067091203,0.0236875630620807
North Carolina,2020-04-24,470,13,8290,294,10488084,2020-04-18,1.11410283476734,0.0235082555594073
North Carolina,2020-04-25,478,11,8768,305,10488084,2020-04-19,1.18473502263687,0.0239793461745473
North Carolina,2020-04-26,229,19,8997,324,10488084,2020-04-20,1.12354334503443,0.0229485798409664
North Carolina,2020-04-27,431,16,9428,340,10488084,2020-04-21,1.15628567889033,0.0229700447600211
North Carolina,2020-04-28,327,23,9755,363,10488084,2020-04-22,1.16298924539214,0.022712207903083
North Carolina,2020-04-29,425,19,10180,382,10488084,2020-04-23,1.15377220422152,0.0222621481158492
North Carolina,2020-04-30,574,24,10754,406,10488084,2020-04-24,1.22346828953448,0.022583365570921
North Carolina,2020-05-01,316,13,11070,419,10488084,2020-04-25,1.1118802784083,0.0210842196880454
North Carolina,2020-05-02,518,12,11588,431,10488084,2020-04-26,1.09991425956583,0.0207089123184626
North Carolina,2020-05-03,182,3,11770,434,10488084,2020-04-27,1.06403382830412,0.0202023647114266
North Carolina,2020-05-04,201,8,11971,442,10488084,2020-04-28,0.964653635482423,0.0191255023822027
North Carolina,2020-05-05,539,30,12510,472,10488084,2020-04-29,1.05339358762397,0.0200655497871598
North Carolina,2020-05-06,543,20,13053,492,10488084,2020-04-30,1.0934047306466,0.0203956507518036
North Carolina,2020-05-07,487,21,13540,513,10488084,2020-05-01,1.04052168024598,0.0197098195968491
North Carolina,2020-05-08,466,17,14006,530,10488084,2020-05-02,1.08603665635098,0.0200397597549921
North Carolina,2020-05-09,472,21,14478,551,10488084,2020-05-03,1.05358016572996,0.019594922058197
North Carolina,2020-05-10,460,13,14938,564,10488084,2020-05-04,1.14130545587952,0.0202740621632274
North Dakota,2020-03-08,0,0,0,0,762062,2020-03-02,5,5
North Dakota,2020-03-09,0,0,0,0,762062,2020-03-03,5,5
North Dakota,2020-03-10,0,0,0,0,762062,2020-03-04,5,5
North Dakota,2020-03-11,0,0,0,0,762062,2020-03-05,5,5
North Dakota,2020-03-12,1,0,1,0,762062,2020-03-06,10,7.07106781186548
North Dakota,2020-03-13,0,0,1,0,762062,2020-03-07,5.21231403354432,3.68566259879299
North Dakota,2020-03-14,0,0,1,0,762062,2020-03-08,3.43785639752253,2.43093157143374
North Dakota,2020-03-15,0,0,1,0,762062,2020-03-09,2.81729392244855,1.99212763715902
North Dakota,2020-03-16,0,0,1,0,762062,2020-03-10,2.48468610732523,1.75693839560968
North Dakota,2020-03-17,2,0,3,0,762062,2020-03-11,4.55346339765226,2.27673169882613
North Dakota,2020-03-18,3,0,6,0,762062,2020-03-12,5.36803232563537,2.02892550905527
North Dakota,2020-03-19,13,0,19,0,762062,2020-03-13,8.26854844632989,1.89693510985907
North Dakota,2020-03-20,7,0,26,0,762062,2020-03-14,4.82328246704713,0.945923516117048
North Dakota,2020-03-21,2,0,28,0,762062,2020-03-15,2.89905574822034,0.547870039050237
North Dakota,2020-03-22,0,0,28,0,762062,2020-03-16,2.08844211738923,0.394678462154648
North Dakota,2020-03-23,2,0,30,0,762062,2020-03-17,1.85206241274257,0.338138787122182
North Dakota,2020-03-24,6,0,36,0,762062,2020-03-18,1.82265428806539,0.312582631607141
North Dakota,2020-03-25,9,0,45,0,762062,2020-03-19,1.86767170814824,0.295304825960285
North Dakota,2020-03-26,6,0,51,0,762062,2020-03-20,1.32701745215267,0.231004087483038
North Dakota,2020-03-27,17,1,68,1,762062,2020-03-21,1.6213787051313,0.247257934500253
North Dakota,2020-03-28,26,0,94,1,762062,2020-03-22,2.30091764179475,0.281101829807685
North Dakota,2020-03-29,4,0,98,1,762062,2020-03-23,1.95657921818638,0.232203232894687
North Dakota,2020-03-30,11,1,109,2,762062,2020-03-24,1.82938418077894,0.204531369259223
North Dakota,2020-03-31,13,1,122,3,762062,2020-03-25,1.71364291869137,0.183721805336504
North Dakota,2020-04-01,20,0,142,3,762062,2020-03-26,1.69431954137096,0.171152119600041
North Dakota,2020-04-02,17,0,159,3,762062,2020-03-27,1.66354342785512,0.159338562180653
North Dakota,2020-04-03,14,0,173,3,762062,2020-03-28,1.43319563812774,0.139204266130557
North Dakota,2020-04-04,13,0,186,3,762062,2020-03-29,1.15773798075184,0.12005183611944
North Dakota,2020-04-05,21,0,207,3,762062,2020-03-30,1.33382902647582,0.127175607719457
North Dakota,2020-04-06,18,0,225,3,762062,2020-03-31,1.35030656313765,0.124835885922778
North Dakota,2020-04-07,12,1,237,4,762062,2020-04-01,1.25326122948347,0.11636238391656
North Dakota,2020-04-08,14,0,251,4,762062,2020-04-02,1.13308308990191,0.108035233672827
North Dakota,2020-04-09,18,1,269,5,762062,2020-04-03,1.11806045659802,0.10612160221147
North Dakota,2020-04-10,9,1,278,6,762062,2020-04-04,1.05053663387931,0.102037138037536
North Dakota,2020-04-11,15,1,293,7,762062,2020-04-05,1.06373834928152,0.102358270384169
North Dakota,2020-04-12,15,0,308,7,762062,2020-04-06,0.998170561221255,0.0988336128664874
North Dakota,2020-04-13,23,1,331,8,762062,2020-04-07,1.04999346578904,0.101506699663779
North Dakota,2020-04-14,10,0,341,8,762062,2020-04-08,1.0263636853971,0.100162839545076
North Dakota,2020-04-15,24,1,365,9,762062,2020-04-09,1.11958009677216,0.104401382345019
North Dakota,2020-04-16,28,0,393,9,762062,2020-04-10,1.19389109293905,0.10678486566173
North Dakota,2020-04-17,0,0,393,9,762062,2020-04-11,1.06724535646721,0.0990912436935336
North Dakota,2020-04-18,135,0,528,9,762062,2020-04-12,2.13649790869096,0.139074168022642
North Dakota,2020-04-19,57,0,585,9,762062,2020-04-13,2.08867204253699,0.125270224480039
North Dakota,2020-04-20,42,0,627,9,762062,2020-04-14,1.79740205839744,0.104295845711924
North Dakota,2020-04-21,17,4,644,13,762062,2020-04-15,1.57517637715111,0.0903425611349235
North Dakota,2020-04-22,35,1,679,14,762062,2020-04-16,1.46301962318905,0.0824318172859693
North Dakota,2020-04-23,30,1,709,15,762062,2020-04-17,1.35259720452005,0.0759694276395758
North Dakota,2020-04-24,39,0,748,15,762062,2020-04-18,1.42393277888942,0.0754682863447175
North Dakota,2020-04-25,55,1,803,16,762062,2020-04-19,1.02465358624594,0.0616768980488053
North Dakota,2020-04-26,64,1,867,17,762062,2020-04-20,1.04034165046866,0.0618418920332069
North Dakota,2020-04-27,75,2,942,19,762062,2020-04-21,1.16939533971921,0.065783627405868
North Dakota,2020-04-28,49,0,991,19,762062,2020-04-22,1.25435465481369,0.0672404674278949
North Dakota,2020-04-29,42,0,1033,19,762062,2020-04-23,1.21923859180836,0.0647104655261044
North Dakota,2020-04-30,34,0,1067,19,762062,2020-04-24,1.17973976401674,0.0622642833184895
North Dakota,2020-05-01,40,4,1107,23,762062,2020-04-25,1.1434547828056,0.0602653585846471
North Dakota,2020-05-02,46,1,1153,24,762062,2020-04-26,1.08597474776184,0.0579650438126828
North Dakota,2020-05-03,38,1,1191,25,762062,2020-04-27,0.990531773432267,0.0549448169090202
North Dakota,2020-05-04,34,0,1225,25,762062,2020-04-28,0.869179534704571,0.0515763164732427
North Dakota,2020-05-05,41,0,1266,25,762062,2020-04-29,0.870370383703163,0.0523901405713468
North Dakota,2020-05-06,57,6,1323,31,762062,2020-04-30,0.948659079582815,0.0556113801202853
North Dakota,2020-05-07,48,0,1371,31,762062,2020-05-01,1.00880827878617,0.0577641940075002
North Dakota,2020-05-08,54,2,1425,33,762062,2020-05-02,1.05338900385127,0.0589784614379572
North Dakota,2020-05-09,39,2,1464,35,762062,2020-05-03,1.01860672048729,0.0576672498216551
North Dakota,2020-05-10,27,0,1491,35,762062,2020-05-04,0.977069827024247,0.056317368572471
Northern Mariana Islands,2020-03-08,0,0,0,0,55144,2020-03-02,5,5
Northern Mariana Islands,2020-03-09,0,0,0,0,55144,2020-03-03,5,5
Northern Mariana Islands,2020-03-10,0,0,0,0,55144,2020-03-04,5,5
Northern Mariana Islands,2020-03-11,0,0,0,0,55144,2020-03-05,5,5
Northern Mariana Islands,2020-03-12,0,0,0,0,55144,2020-03-06,5,5
Northern Mariana Islands,2020-03-13,0,0,0,0,55144,2020-03-07,5,5
Northern Mariana Islands,2020-03-14,0,0,0,0,55144,2020-03-08,5,5
Northern Mariana Islands,2020-03-15,0,0,0,0,55144,2020-03-09,5,5
Northern Mariana Islands,2020-03-16,0,0,0,0,55144,2020-03-10,5,5
Northern Mariana Islands,2020-03-17,0,0,0,0,55144,2020-03-11,5,5
Northern Mariana Islands,2020-03-18,0,0,0,0,55144,2020-03-12,5,5
Northern Mariana Islands,2020-03-19,0,0,0,0,55144,2020-03-13,5,5
Northern Mariana Islands,2020-03-20,0,0,0,0,55144,2020-03-14,5,5
Northern Mariana Islands,2020-03-21,0,0,0,0,55144,2020-03-15,5,5
Northern Mariana Islands,2020-03-22,0,0,0,0,55144,2020-03-16,5,5
Northern Mariana Islands,2020-03-23,0,0,0,0,55144,2020-03-17,5,5
Northern Mariana Islands,2020-03-24,0,0,0,0,55144,2020-03-18,5,5
Northern Mariana Islands,2020-03-25,0,0,0,0,55144,2020-03-19,5,5
Northern Mariana Islands,2020-03-26,0,0,0,0,55144,2020-03-20,5,5
Northern Mariana Islands,2020-03-27,0,0,0,0,55144,2020-03-21,5,5
Northern Mariana Islands,2020-03-28,0,0,0,0,55144,2020-03-22,5,5
Northern Mariana Islands,2020-03-29,0,0,0,0,55144,2020-03-23,5,5
Northern Mariana Islands,2020-03-30,0,0,0,0,55144,2020-03-24,5,5
Northern Mariana Islands,2020-03-31,2,0,2,0,55144,2020-03-25,15,8.66025403784439
Northern Mariana Islands,2020-04-01,4,1,6,1,55144,2020-03-26,12.336682804049,4.66282781471439
Northern Mariana Islands,2020-04-02,0,0,6,1,55144,2020-03-27,4.121665266737,1.55784304046268
Northern Mariana Islands,2020-04-03,2,0,8,1,55144,2020-03-28,3.2764998661408,1.09216662204693
Northern Mariana Islands,2020-04-04,0,0,8,1,55144,2020-03-29,2.35794736693605,0.78598245564535
Northern Mariana Islands,2020-04-05,0,0,8,1,55144,2020-03-30,1.89867699566038,0.632892331886793
Northern Mariana Islands,2020-04-06,0,0,8,1,55144,2020-03-31,1.66456559680479,0.554855198934931
Northern Mariana Islands,2020-04-07,0,1,8,2,55144,2020-04-01,1.18188789358305,0.446711634854103
Northern Mariana Islands,2020-04-08,3,0,11,2,55144,2020-04-02,1.00598057195564,0.410689848740751
Northern Mariana Islands,2020-04-09,0,0,11,2,55144,2020-04-03,1.05018887274765,0.428737811963401
Northern Mariana Islands,2020-04-10,0,0,11,2,55144,2020-04-04,0.723912379364529,0.361956189682264
Northern Mariana Islands,2020-04-11,0,0,11,2,55144,2020-04-05,0.790898103916191,0.395449051958095
Northern Mariana Islands,2020-04-12,0,0,11,2,55144,2020-04-06,0.86996627408631,0.434983137043155
Northern Mariana Islands,2020-04-13,0,0,11,2,55144,2020-04-07,0.930500479769415,0.465250239884708
Northern Mariana Islands,2020-04-14,0,0,11,2,55144,2020-04-08,0.980701811474419,0.49035090573721
Northern Mariana Islands,2020-04-15,2,0,13,2,55144,2020-04-09,0.767241768554042,0.442967241608201
Northern Mariana Islands,2020-04-16,0,0,13,2,55144,2020-04-10,0.834653900654273,0.481887654222916
Northern Mariana Islands,2020-04-17,0,0,13,2,55144,2020-04-11,0.911507879086778,0.526259319359216
Northern Mariana Islands,2020-04-18,1,0,14,2,55144,2020-04-12,1.29921215057241,0.649606075286203
Northern Mariana Islands,2020-04-19,0,0,14,2,55144,2020-04-13,1.29063697938403,0.645318489692014
Northern Mariana Islands,2020-04-20,0,0,14,2,55144,2020-04-14,1.26252588771638,0.631262943858189
Northern Mariana Islands,2020-04-21,0,0,14,2,55144,2020-04-15,1.25280110192547,0.626400550962733
Northern Mariana Islands,2020-04-22,0,0,14,2,55144,2020-04-16,0.624222671366241,0.441392083893451
Northern Mariana Islands,2020-04-23,0,0,14,2,55144,2020-04-17,0.703810609906703,0.497669254936069
Northern Mariana Islands,2020-04-24,0,0,14,2,55144,2020-04-18,0.817113652129049,0.577786604420556
Northern Mariana Islands,2020-04-25,0,0,14,2,55144,2020-04-19,0.456239597815356,0.456239597815356
Northern Mariana Islands,2020-04-26,0,0,14,2,55144,2020-04-20,0.550143792337183,0.550143792337183
Northern Mariana Islands,2020-04-27,0,0,14,2,55144,2020-04-21,0.679424367582092,0.679424367582092
Northern Mariana Islands,2020-04-28,0,0,14,2,55144,2020-04-22,0.815376842006663,0.815376842006663
Northern Mariana Islands,2020-04-29,0,0,14,2,55144,2020-04-23,0.9641992489104,0.9641992489104
Northern Mariana Islands,2020-04-30,0,0,14,2,55144,2020-04-24,1.12721318691488,1.12721318691488
Northern Mariana Islands,2020-05-01,0,0,14,2,55144,2020-04-25,1.30452187448981,1.30452187448981
Northern Mariana Islands,2020-05-02,0,0,14,2,55144,2020-04-26,1.49539879041615,1.49539879041615
Northern Mariana Islands,2020-05-03,0,0,14,2,55144,2020-04-27,1.69838294846447,1.69838294846447
Northern Mariana Islands,2020-05-04,0,0,14,2,55144,2020-04-28,1.91134261737101,1.91134261737101
Northern Mariana Islands,2020-05-05,0,0,14,2,55144,2020-04-29,2.13157002170262,2.13157002170262
Northern Mariana Islands,2020-05-06,1,0,15,2,55144,2020-04-30,4.71184652476508,3.33177862957166
Northern Mariana Islands,2020-05-07,0,0,15,2,55144,2020-05-01,3.5016959868125,2.47607297792884
Northern Mariana Islands,2020-05-08,0,0,15,2,55144,2020-05-02,2.70831238391295,1.91506605223635
Northern Mariana Islands,2020-05-09,1,0,16,2,55144,2020-05-03,3.56699287113733,2.05940429434861
Northern Mariana Islands,2020-05-10,0,0,16,2,55144,2020-05-04,2.73104037040922,1.5767668930235
Ohio,2020-03-08,0,0,0,0,11689100,2020-03-02,5,5
Ohio,2020-03-09,0,0,0,0,11689100,2020-03-03,5,5
Ohio,2020-03-10,3,0,3,0,11689100,2020-03-04,20,10
Ohio,2020-03-11,1,0,4,0,11689100,2020-03-05,6.65672413710444,2.97697753560583
Ohio,2020-03-12,1,0,5,0,11689100,2020-03-06,3.92418389898591,1.60204136822682
Ohio,2020-03-13,7,0,12,0,11689100,2020-03-07,5.66407378101017,1.57093141888026
Ohio,2020-03-14,14,0,26,0,11689100,2020-03-08,6.44022818390122,1.23942249187266
Ohio,2020-03-15,4,0,30,0,11689100,2020-03-09,3.60700506099661,0.647837233392403
Ohio,2020-03-16,20,0,50,0,11689100,2020-03-10,3.82253397304228,0.535261819297157
Ohio,2020-03-17,17,0,67,0,11689100,2020-03-11,3.16470567093056,0.392533427946834
Ohio,2020-03-18,22,0,89,0,11689100,2020-03-12,2.90074353855299,0.312795220114124
Ohio,2020-03-19,30,0,119,0,11689100,2020-03-13,2.81627577960551,0.262619070581288
Ohio,2020-03-20,54,3,173,3,11689100,2020-03-14,2.91399197865584,0.228944832047861
Ohio,2020-03-21,74,0,247,3,11689100,2020-03-15,2.8932259068738,0.194180608650043
Ohio,2020-03-22,109,0,356,3,11689100,2020-03-16,3.08510834198903,0.170606881149162
Ohio,2020-03-23,87,3,443,6,11689100,2020-03-17,2.62539994135536,0.132265738242618
Ohio,2020-03-24,124,2,567,8,11689100,2020-03-18,2.49528402130696,0.111481068512579
Ohio,2020-03-25,137,3,704,11,11689100,2020-03-19,2.36294867112727,0.0952059151003807
Ohio,2020-03-26,164,4,868,15,11689100,2020-03-20,2.25725103243087,0.0824231538942809
Ohio,2020-03-27,269,4,1137,19,11689100,2020-03-21,2.31956181422353,0.0746693367784017
Ohio,2020-03-28,269,6,1406,25,11689100,2020-03-22,2.2097640482489,0.0648809064744211
Ohio,2020-03-29,247,4,1653,29,11689100,2020-03-23,1.98541437921557,0.0551078942915445
Ohio,2020-03-30,280,11,1933,40,11689100,2020-03-24,1.90074478894882,0.0492249163481355
Ohio,2020-03-31,266,15,2199,55,11689100,2020-03-25,1.76781230334214,0.0437464745485196
Ohio,2020-04-01,348,10,2547,65,11689100,2020-03-26,1.73125501991112,0.0403162924923588
Ohio,2020-04-02,354,16,2901,81,11689100,2020-03-27,1.67126210518996,0.0370569005210385
Ohio,2020-04-03,411,10,3312,91,11689100,2020-03-28,1.57861902701485,0.0338413662015113
Ohio,2020-04-04,427,11,3739,102,11689100,2020-03-29,1.5197779772147,0.0314578995329912
Ohio,2020-04-05,304,17,4043,119,11689100,2020-03-30,1.41426837531834,0.0289229137238834
Ohio,2020-04-06,410,23,4453,142,11689100,2020-03-31,1.37960091291441,0.027476856793094
Ohio,2020-04-07,329,25,4782,167,11689100,2020-04-01,1.3199043166293,0.0259654703810986
Ohio,2020-04-08,366,26,5148,193,11689100,2020-04-02,1.25242337485618,0.0245526016903317
Ohio,2020-04-09,364,20,5512,213,11689100,2020-04-03,1.20041526933396,0.0234879397782532
Ohio,2020-04-10,366,18,5878,231,11689100,2020-04-04,1.1383342860719,0.0224676103001859
Ohio,2020-04-11,372,16,6250,247,11689100,2020-04-05,1.08740595704449,0.0216961108102292
Ohio,2020-04-12,354,6,6604,253,11689100,2020-04-06,1.09398274554267,0.0216132914365973
Ohio,2020-04-13,371,21,6975,274,11689100,2020-04-07,1.06196460860227,0.0211422604360818
Ohio,2020-04-14,310,50,7285,324,11689100,2020-04-08,1.04286300943609,0.0208405943768807
Ohio,2020-04-15,509,38,7794,362,11689100,2020-04-09,1.09577941953774,0.0212983602587156
Ohio,2020-04-16,620,45,8414,407,11689100,2020-04-10,1.18283407833713,0.0219533251853795
Ohio,2020-04-17,693,11,9107,418,11689100,2020-04-11,1.27117669837885,0.0223668416020499
Ohio,2020-04-18,1115,33,10222,451,11689100,2020-04-12,1.48253332406063,0.0235204259032781
Ohio,2020-04-19,1380,20,11602,471,11689100,2020-04-13,1.70270569816549,0.0240823032615056
Ohio,2020-04-20,1317,38,12919,509,11689100,2020-04-14,1.77176055849189,0.0229788928513559
Ohio,2020-04-21,806,48,13725,557,11689100,2020-04-15,1.65499377680862,0.0206214745003613
Ohio,2020-04-22,392,53,14117,610,11689100,2020-04-16,1.42976586313015,0.0179791432655623
Ohio,2020-04-23,577,46,14694,656,11689100,2020-04-17,1.30478078678331,0.0164635374644345
Ohio,2020-04-24,475,34,15169,690,11689100,2020-04-18,1.19167743718975,0.0153043515284468
Ohio,2020-04-25,418,21,15587,711,11689100,2020-04-19,1.01974767661075,0.0139209024545699
Ohio,2020-04-26,385,17,15972,728,11689100,2020-04-20,0.830415899400526,0.012560451545562
Ohio,2020-04-27,353,25,16325,753,11689100,2020-04-21,0.674008001104973,0.0115472610819757
Ohio,2020-04-28,444,46,16769,799,11689100,2020-04-22,0.649979400085648,0.0117789328029155
Ohio,2020-04-29,534,138,17303,937,11689100,2020-04-23,0.739258984505473,0.0130950023182314
Ohio,2020-04-30,724,39,18027,976,11689100,2020-04-24,0.821106450504221,0.014220558922162
Ohio,2020-05-01,716,27,18743,1003,11689100,2020-04-25,0.912656544551944,0.0152640348652449
Ohio,2020-05-02,592,19,19335,1022,11689100,2020-04-26,0.971900645188091,0.0158731876420833
Ohio,2020-05-03,579,17,19914,1039,11689100,2020-04-27,1.02391224438048,0.0163060717123212
Ohio,2020-05-04,560,18,20474,1057,11689100,2020-04-28,1.06902381049793,0.0165944678502112
Ohio,2020-05-05,495,78,20969,1135,11689100,2020-04-29,1.06435906275157,0.016421462074898
Ohio,2020-05-06,607,90,21576,1225,11689100,2020-04-30,1.06577616615105,0.0163022948992937
Ohio,2020-05-07,555,46,22131,1271,11689100,2020-05-01,1.00917701792543,0.0157510957297937
Ohio,2020-05-08,885,35,23016,1306,11689100,2020-05-02,1.04707617469715,0.0160162566250501
Ohio,2020-05-09,681,25,23697,1331,11689100,2020-05-03,1.06110740129649,0.016064482407572
Ohio,2020-05-10,384,10,24081,1341,11689100,2020-05-04,1.00083418536978,0.0155023763471921
Oklahoma,2020-03-08,0,0,1,0,3956971,2020-03-02,5.21231403354432,3.68566259879299
Oklahoma,2020-03-09,0,0,1,0,3956971,2020-03-03,3.43785639752253,2.43093157143374
Oklahoma,2020-03-10,1,0,2,0,3956971,2020-03-04,4.22594088367282,2.43984810676795
Oklahoma,2020-03-11,0,0,2,0,3956971,2020-03-05,3.03447962767621,1.7519576298893
Oklahoma,2020-03-12,1,0,3,0,3956971,2020-03-06,3.17407396347988,1.58703698173994
Oklahoma,2020-03-13,0,0,3,0,3956971,2020-03-07,2.4536711042928,1.2268355521464
Oklahoma,2020-03-14,1,0,4,0,3956971,2020-03-08,2.03054281468934,1.01527140734467
Oklahoma,2020-03-15,0,0,4,0,3956971,2020-03-09,1.81051462634382,0.905257313171911
Oklahoma,2020-03-16,6,0,10,0,3956971,2020-03-10,4.17842841991336,1.32133508469047
Oklahoma,2020-03-17,7,0,17,0,3956971,2020-03-11,4.39461961976217,1.09865490494054
Oklahoma,2020-03-18,0,0,17,0,3956971,2020-03-12,2.645520631707,0.66138015792675
Oklahoma,2020-03-19,27,1,44,1,3956971,2020-03-13,5.18545025584426,0.800132345538557
Oklahoma,2020-03-20,5,0,49,1,3956971,2020-03-14,3.288540763612,0.479682970524745
Oklahoma,2020-03-21,4,0,53,1,3956971,2020-03-15,2.33269849409495,0.329893384727637
Oklahoma,2020-03-22,14,1,67,2,3956971,2020-03-16,2.35731405583329,0.294664256979161
Oklahoma,2020-03-23,14,0,81,2,3956971,2020-03-17,2.11151858953976,0.248844852210837
Oklahoma,2020-03-24,25,1,106,3,3956971,2020-03-18,2.16066117875541,0.227753685892377
Oklahoma,2020-03-25,58,2,164,5,3956971,2020-03-19,2.90514711674754,0.238801621983187
Oklahoma,2020-03-26,84,2,248,7,3956971,2020-03-20,2.94526529868504,0.205706251368047
Oklahoma,2020-03-27,74,1,322,8,3956971,2020-03-21,2.81481524614665,0.170049207883981
Oklahoma,2020-03-28,55,7,377,15,3956971,2020-03-22,2.43950584182414,0.135319436915244
Oklahoma,2020-03-29,52,1,429,16,3956971,2020-03-23,2.10265608403078,0.110360823284398
Oklahoma,2020-03-30,52,0,481,16,3956971,2020-03-24,1.89944101940491,0.0948535580345585
Oklahoma,2020-03-31,87,7,568,23,3956971,2020-03-25,1.8623470259641,0.0865506062420026
Oklahoma,2020-04-01,153,7,721,30,3956971,2020-03-26,1.92252795302466,0.0813870980651826
Oklahoma,2020-04-02,160,4,881,34,3956971,2020-03-27,1.85038877134471,0.0734883261305773
Oklahoma,2020-04-03,109,4,990,38,3956971,2020-03-28,1.66763549697158,0.0644745132292054
Oklahoma,2020-04-04,171,4,1161,42,3956971,2020-03-29,1.72534593921332,0.0615802372338993
Oklahoma,2020-04-05,93,4,1254,46,3956971,2020-03-30,1.59429190554987,0.0554725100440148
Oklahoma,2020-04-06,75,5,1329,51,3956971,2020-03-31,1.46298473880755,0.0502095062536737
Oklahoma,2020-04-07,145,16,1474,67,3956971,2020-04-01,1.43380795603498,0.0476088117670589
Oklahoma,2020-04-08,52,12,1526,79,3956971,2020-04-02,1.17804048700077,0.0414947063653147
Oklahoma,2020-04-09,160,1,1686,80,3956971,2020-04-03,1.13711518019016,0.0400531739156616
Oklahoma,2020-04-10,108,8,1794,88,3956971,2020-04-04,1.11570805431751,0.0393235418949821
Oklahoma,2020-04-11,74,6,1868,94,3956971,2020-04-05,0.964150088865134,0.0362349792347026
Oklahoma,2020-04-12,102,2,1970,96,3956971,2020-04-06,0.985408954998059,0.0368007717877039
Oklahoma,2020-04-13,99,3,2069,99,3956971,2020-04-07,1.02985768442916,0.0378327673629594
Oklahoma,2020-04-14,115,9,2184,108,3956971,2020-04-08,0.985801984008425,0.0369704628305583
Oklahoma,2020-04-15,79,15,2263,123,3956971,2020-04-09,1.02629113337579,0.0377782986852573
Oklahoma,2020-04-16,94,8,2357,131,3956971,2020-04-10,0.9326821146934,0.0359789936867299
Oklahoma,2020-04-17,108,5,2465,136,3956971,2020-04-11,0.944002006357836,0.0364156679879875
Oklahoma,2020-04-18,0,0,2465,136,3956971,2020-04-12,0.852965448445555,0.0348803510595388
Oklahoma,2020-04-19,102,4,2567,140,3956971,2020-04-13,0.878342557740127,0.0359180982305222
Oklahoma,2020-04-20,113,3,2680,143,3956971,2020-04-14,0.9253581350152,0.0374053856097278
Oklahoma,2020-04-21,127,21,2807,164,3956971,2020-04-15,0.958794116943371,0.0383824829563302
Oklahoma,2020-04-22,87,6,2894,170,3956971,2020-04-16,0.978419564555303,0.0389194405781009
Oklahoma,2020-04-23,123,9,3017,179,3956971,2020-04-17,1.02653554231623,0.0399276050551993
Oklahoma,2020-04-24,104,9,3121,188,3956971,2020-04-18,1.01449086047969,0.0395790580435108
Oklahoma,2020-04-25,73,6,3194,194,3956971,2020-04-19,1.12145203099944,0.0415068018494669
Oklahoma,2020-04-26,60,1,3254,195,3956971,2020-04-20,1.03336498784957,0.0393966708197072
Oklahoma,2020-04-27,27,2,3281,197,3956971,2020-04-21,0.89384358564014,0.0364303448500978
Oklahoma,2020-04-28,129,10,3410,207,3956971,2020-04-22,0.915972976312112,0.0372704118334533
Oklahoma,2020-04-29,63,7,3473,214,3956971,2020-04-23,0.89952341568714,0.0373506768477069
Oklahoma,2020-04-30,145,8,3618,222,3956971,2020-04-24,0.953300126667108,0.0388536125537589
Oklahoma,2020-05-01,130,8,3748,230,3956971,2020-04-25,1.00593650406483,0.0401412365250676
Oklahoma,2020-05-02,103,8,3851,238,3956971,2020-04-26,1.05214088107129,0.0410167219517589
Oklahoma,2020-05-03,121,0,3972,238,3956971,2020-04-27,1.13640405035821,0.0423807197233669
Oklahoma,2020-05-04,72,0,4044,238,3956971,2020-04-28,1.17466403189047,0.0424978531613175
Oklahoma,2020-05-05,83,9,4127,247,3956971,2020-04-29,1.06404815798393,0.0397099245698604
Oklahoma,2020-05-06,75,6,4202,253,3956971,2020-04-30,1.06421697751832,0.0393884374807589
Oklahoma,2020-05-07,128,7,4330,260,3956971,2020-05-01,1.02917954669871,0.0385430769254626
Oklahoma,2020-05-08,94,6,4424,266,3956971,2020-05-02,0.971875703820404,0.0373522175921236
Oklahoma,2020-05-09,66,4,4490,270,3956971,2020-05-03,0.924906133033361,0.0365601250280515
Oklahoma,2020-05-10,99,2,4589,272,3956971,2020-05-04,0.908640496455863,0.0365508811425527
Oregon,2020-03-08,8,0,14,0,4217737,2020-03-02,6.29404355435532,1.68215389698789
Oregon,2020-03-09,0,0,14,0,4217737,2020-03-03,2.73886081549188,0.790641014548578
Oregon,2020-03-10,0,0,14,0,4217737,2020-03-04,1.98076044855812,0.571796289087599
Oregon,2020-03-11,5,0,19,0,4217737,2020-03-05,2.41686444151482,0.586175727950885
Oregon,2020-03-12,5,0,24,0,4217737,2020-03-06,2.52081873354269,0.537440359793944
Oregon,2020-03-13,6,0,30,0,4217737,2020-03-07,2.48886723069099,0.470351695619028
Oregon,2020-03-14,6,0,36,0,4217737,2020-03-08,2.14154637066488,0.384633082707609
Oregon,2020-03-15,0,1,36,1,4217737,2020-03-09,1.29730987602101,0.270507808648978
Oregon,2020-03-16,3,0,39,1,4217737,2020-03-10,1.38375697249498,0.27137706941623
Oregon,2020-03-17,27,0,66,1,4217737,2020-03-11,2.69931047867727,0.370778809623715
Oregon,2020-03-18,9,2,75,3,4217737,2020-03-12,2.22377025105618,0.294545565220256
Oregon,2020-03-19,13,0,88,3,4217737,2020-03-13,1.99939092835898,0.247993923139077
Oregon,2020-03-20,26,0,114,3,4217737,2020-03-14,2.18654465695043,0.237164066736597
Oregon,2020-03-21,23,1,137,4,4217737,2020-03-15,2.13675930824263,0.211570697898898
Oregon,2020-03-22,24,1,161,5,4217737,2020-03-16,2.14865193912079,0.19141712856232
Oregon,2020-03-23,30,0,191,5,4217737,2020-03-17,2.12617568202513,0.171891115992339
Oregon,2020-03-24,19,3,210,8,4217737,2020-03-18,1.64536256134105,0.136639923439946
Oregon,2020-03-25,56,2,266,10,4217737,2020-03-19,1.91846149875042,0.138453032841686
Oregon,2020-03-26,50,1,316,11,4217737,2020-03-20,1.95993836540989,0.12951637276084
Oregon,2020-03-27,100,1,416,12,4217737,2020-03-21,2.17288627174611,0.124829054727261
Oregon,2020-03-28,63,1,479,13,4217737,2020-03-22,1.99877378175096,0.107923639869166
Oregon,2020-03-29,69,0,548,13,4217737,2020-03-23,1.87405705973811,0.0951408324423337
Oregon,2020-03-30,58,3,606,16,4217737,2020-03-24,1.71108844818296,0.0838930133343087
Oregon,2020-03-31,84,2,690,18,4217737,2020-03-25,1.732675052844,0.0790031821084428
Oregon,2020-04-01,46,1,736,19,4217737,2020-03-26,1.48692468723573,0.0685138730277557
Oregon,2020-04-02,90,2,826,21,4217737,2020-03-27,1.46705105697416,0.0648985178559587
Oregon,2020-04-03,73,1,899,22,4217737,2020-03-28,1.27979584884533,0.0581725385838787
Oregon,2020-04-04,0,0,899,22,4217737,2020-03-29,1.05511048997519,0.0514229388183117
Oregon,2020-04-05,169,5,1068,27,4217737,2020-03-30,1.29746696388145,0.0568430597367658
Oregon,2020-04-06,0,0,1068,27,4217737,2020-03-31,1.10394184189973,0.0513045282862207
Oregon,2020-04-07,64,2,1132,29,4217737,2020-04-01,1.02941435741394,0.0489089521100284
Oregon,2020-04-08,49,4,1181,33,4217737,2020-04-02,1.03689845418357,0.0490985648253689
Oregon,2020-04-09,140,11,1321,44,4217737,2020-04-03,1.15118489514279,0.0516897276951954
Oregon,2020-04-10,1,0,1322,44,4217737,2020-04-04,0.959713047288344,0.0466077857375489
Oregon,2020-04-11,49,4,1371,48,4217737,2020-04-05,1.07458920849109,0.0494096644475049
Oregon,2020-04-12,156,4,1527,52,4217737,2020-04-06,1.03869755176256,0.0484295230663016
Oregon,2020-04-13,57,1,1584,53,4217737,2020-04-07,1.15641908887128,0.050859253376122
Oregon,2020-04-14,49,2,1633,55,4217737,2020-04-08,1.09304550567001,0.0487850084220947
Oregon,2020-04-15,30,3,1663,58,4217737,2020-04-09,1.02891110152626,0.046817076188773
Oregon,2020-04-16,73,6,1736,64,4217737,2020-04-10,0.881993151517345,0.0432432720234821
Oregon,2020-04-17,49,6,1785,70,4217737,2020-04-11,1.00814182127265,0.0468018091079134
Oregon,2020-04-18,59,2,1844,72,4217737,2020-04-12,1.03693477632843,0.0476279916800542
Oregon,2020-04-19,66,2,1910,74,4217737,2020-04-13,0.832775799337935,0.0424974120524236
Oregon,2020-04-20,47,1,1957,75,4217737,2020-04-14,0.835896596530918,0.0432231840174871
Oregon,2020-04-21,47,3,2004,78,4217737,2020-04-15,0.865899947779999,0.0448948209158728
Oregon,2020-04-22,55,0,2059,78,4217737,2020-04-16,0.951796133447975,0.0477692786104048
Oregon,2020-04-23,68,5,2127,83,4217737,2020-04-17,0.950205301500574,0.0479926151578903
Oregon,2020-04-24,50,3,2177,86,4217737,2020-04-18,0.959449571213197,0.0483978286819007
Oregon,2020-04-25,76,1,2253,87,4217737,2020-04-19,1.0085017902455,0.0498063533249789
Oregon,2020-04-26,58,5,2311,92,4217737,2020-04-20,0.987123798493824,0.049233260244581
Oregon,2020-04-27,43,0,2354,92,4217737,2020-04-21,0.977595354818258,0.0490024273258449
Oregon,2020-04-28,31,7,2385,99,4217737,2020-04-22,0.942486466070545,0.0482218026205388
Oregon,2020-04-29,61,2,2446,101,4217737,2020-04-23,0.968088993005609,0.0491472723278156
Oregon,2020-04-30,64,2,2510,103,4217737,2020-04-24,0.965896451242758,0.049290696873121
Oregon,2020-05-01,69,1,2579,104,4217737,2020-04-25,1.02016185935934,0.0508178818904334
Oregon,2020-05-02,56,5,2635,109,4217737,2020-04-26,0.966610212065499,0.0493914745677033
Oregon,2020-05-03,45,0,2680,109,4217737,2020-04-27,0.937697840070502,0.0487485894258264
Oregon,2020-05-04,79,0,2759,109,4217737,2020-04-28,1.04292236183047,0.0517593677489264
Oregon,2020-05-05,80,4,2839,113,4217737,2020-04-29,1.1623164526838,0.0544902357656945
Oregon,2020-05-06,77,2,2916,115,4217737,2020-04-30,1.16435707939936,0.0536507422210074
Oregon,2020-05-07,73,6,2989,121,4217737,2020-05-01,1.14441607764464,0.0522352084081295
Oregon,2020-05-08,79,3,3068,124,4217737,2020-05-02,1.13398328151471,0.0512281428305485
Oregon,2020-05-09,92,3,3160,127,4217737,2020-05-03,1.18575068089437,0.0517011865857582
Oregon,2020-05-10,68,0,3228,127,4217737,2020-05-04,1.19511837181665,0.0510064091592955
Pennsylvania,2020-03-08,4,0,6,0,12801989,2020-03-02,7.26506041737795,2.74593473203445
Pennsylvania,2020-03-09,1,0,7,0,12801989,2020-03-03,4.09284809767807,1.44704032211731
Pennsylvania,2020-03-10,5,0,12,0,12801989,2020-03-04,4.16586621329302,1.15540340298085
Pennsylvania,2020-03-11,4,0,16,0,12801989,2020-03-05,3.47165475263518,0.84199995534073
Pennsylvania,2020-03-12,6,0,22,0,12801989,2020-03-06,3.17397013832311,0.661818523627095
Pennsylvania,2020-03-13,19,0,41,0,12801989,2020-03-07,3.89712640397013,0.616189788306354
Pennsylvania,2020-03-14,6,0,47,0,12801989,2020-03-08,2.88498780088137,0.425368244844964
Pennsylvania,2020-03-15,0,0,47,0,12801989,2020-03-09,1.88879058290787,0.291446714319536
Pennsylvania,2020-03-16,32,0,79,0,12801989,2020-03-10,2.77869606071313,0.325221774655233
Pennsylvania,2020-03-17,33,0,112,0,12801989,2020-03-11,2.91340097016657,0.28989423153096
Pennsylvania,2020-03-18,43,1,155,1,12801989,2020-03-12,2.90770302642764,0.245745758427231
Pennsylvania,2020-03-19,51,0,206,1,12801989,2020-03-13,2.77774844452142,0.204224127291048
Pennsylvania,2020-03-20,105,0,311,1,12801989,2020-03-14,2.99246792973156,0.181779481084744
Pennsylvania,2020-03-21,88,1,399,2,12801989,2020-03-15,2.79316567755993,0.14866520843542
Pennsylvania,2020-03-22,110,2,509,4,12801989,2020-03-16,2.67987354309872,0.124544285556567
Pennsylvania,2020-03-23,189,2,698,6,12801989,2020-03-17,2.68115045900283,0.107677593618344
Pennsylvania,2020-03-24,248,2,946,8,12801989,2020-03-18,2.70003879625934,0.0934386955277248
Pennsylvania,2020-03-25,314,7,1260,15,12801989,2020-03-19,2.66479892635627,0.080128475713515
Pennsylvania,2020-03-26,535,3,1795,18,12801989,2020-03-20,2.86658959265318,0.0718897474023736
Pennsylvania,2020-03-27,550,4,2345,22,12801989,2020-03-21,2.6733972742971,0.0592626809171965
Pennsylvania,2020-03-28,500,12,2845,34,12801989,2020-03-22,2.39254418272384,0.0483663129814585
Pennsylvania,2020-03-29,587,7,3432,41,12801989,2020-03-23,2.22649596030384,0.0411749639262263
Pennsylvania,2020-03-30,723,9,4155,50,12801989,2020-03-24,2.11282018293442,0.0359294064192224
Pennsylvania,2020-03-31,808,13,4963,63,12801989,2020-03-25,2.00801761402023,0.0316783499287752
Pennsylvania,2020-04-01,1046,11,6009,74,12801989,2020-03-26,1.97584619727414,0.0286685897998514
Pennsylvania,2020-04-02,1259,16,7268,90,12801989,2020-03-27,1.90794027541432,0.0257876863444201
Pennsylvania,2020-04-03,1302,12,8570,102,12801989,2020-03-28,1.83665698178742,0.0232768118367142
Pennsylvania,2020-04-04,1874,34,10444,136,12801989,2020-03-29,1.92180068124617,0.0220445656820518
Pennsylvania,2020-04-05,1145,15,11589,151,12801989,2020-03-30,1.74714392861801,0.0193435790614848
Pennsylvania,2020-04-06,1538,28,13127,179,12801989,2020-03-31,1.66634245902832,0.0175911983920114
Pennsylvania,2020-04-07,1726,68,14853,247,12801989,2020-04-01,1.62477753648965,0.0163370562787102
Pennsylvania,2020-04-08,1778,71,16631,318,12801989,2020-04-02,1.55478778808689,0.0150850769580685
Pennsylvania,2020-04-09,1669,27,18300,345,12801989,2020-04-03,1.45571925833652,0.0138589656521969
Pennsylvania,2020-04-10,1751,73,20051,418,12801989,2020-04-04,1.39085798734127,0.0129799798309162
Pennsylvania,2020-04-11,1668,85,21719,503,12801989,2020-04-05,1.271089637483,0.0119701238683487
Pennsylvania,2020-04-12,1219,54,22938,557,12801989,2020-04-06,1.21632812893971,0.0114170215194002
Pennsylvania,2020-04-13,1354,32,24292,589,12801989,2020-04-07,1.15267886439674,0.0109083614074873
Pennsylvania,2020-04-14,1173,102,25465,691,12801989,2020-04-08,1.06700019479409,0.0103572728315868
Pennsylvania,2020-04-15,1288,88,26753,779,12801989,2020-04-09,1.00775579933776,0.0100161469514443
Pennsylvania,2020-04-16,1505,62,28258,841,12801989,2020-04-10,0.994416195066041,0.00996461038311685
Pennsylvania,2020-04-17,1630,80,29888,921,12801989,2020-04-11,0.987977399771348,0.0099607858001643
Pennsylvania,2020-04-18,1764,121,31652,1042,12801989,2020-04-12,1.0029692198259,0.0100629549238629
Pennsylvania,2020-04-19,1250,234,32902,1276,12801989,2020-04-13,1.00787240920459,0.0100964082937998
Pennsylvania,2020-04-20,1012,72,33914,1348,12801989,2020-04-14,0.972669002756594,0.00991539073305337
Pennsylvania,2020-04-21,1335,266,35249,1614,12801989,2020-04-15,0.994565585307518,0.0100543271519833
Pennsylvania,2020-04-22,833,59,36082,1673,12801989,2020-04-16,0.951307837389819,0.00984873048265446
Pennsylvania,2020-04-23,2297,51,38379,1724,12801989,2020-04-17,1.04147696537079,0.0103518150117044
Pennsylvania,2020-04-24,1829,23,40208,1747,12801989,2020-04-18,1.05653658821732,0.010399768031229
Pennsylvania,2020-04-25,945,46,41153,1793,12801989,2020-04-19,0.959828480118268,0.00984659599391859
Pennsylvania,2020-04-26,1463,23,42616,1816,12801989,2020-04-20,0.986901346923641,0.0100127261717063
Pennsylvania,2020-04-27,942,70,43558,1886,12801989,2020-04-21,0.985581315698333,0.0100355538508948
Pennsylvania,2020-04-28,1579,160,45137,2046,12801989,2020-04-22,1.01324707739224,0.0101891785178111
Pennsylvania,2020-04-29,1190,327,46327,2373,12801989,2020-04-23,1.04779706259532,0.0103514216867675
Pennsylvania,2020-04-30,1644,102,47971,2475,12801989,2020-04-24,0.971519029007797,0.00991914158181193
Pennsylvania,2020-05-01,1608,160,49579,2635,12801989,2020-04-25,0.952212092320307,0.00983597808405109
Pennsylvania,2020-05-02,915,60,50494,2695,12801989,2020-04-26,0.960072081909136,0.00993307945638024
Pennsylvania,2020-05-03,731,25,51225,2720,12801989,2020-04-27,0.893075097314987,0.00962468232242944
Pennsylvania,2020-05-04,1591,118,52816,2838,12801989,2020-04-28,0.980449568816324,0.0101892734555202
Pennsylvania,2020-05-05,1048,341,53864,3179,12801989,2020-04-29,0.931322261602677,0.00996879385555479
Pennsylvania,2020-05-06,936,166,54800,3345,12801989,2020-04-30,0.913826433701126,0.00992703348122804
Pennsylvania,2020-05-07,1156,244,55956,3589,12801989,2020-05-01,0.876938704008007,0.00981306296125722
Pennsylvania,2020-05-08,1415,126,57371,3715,12801989,2020-05-02,0.877197666747882,0.00993676753140436
Pennsylvania,2020-05-09,1189,64,58560,3779,12801989,2020-05-03,0.931978949074099,0.0103764805041528
Pennsylvania,2020-05-10,1379,27,59939,3806,12801989,2020-05-04,1.02157443764718,0.0109429980424256
Puerto Rico,2020-03-08,0,0,0,0,2933408,2020-03-02,5,5
Puerto Rico,2020-03-09,0,0,0,0,2933408,2020-03-03,5,5
Puerto Rico,2020-03-10,0,0,0,0,2933408,2020-03-04,5,5
Puerto Rico,2020-03-11,0,0,0,0,2933408,2020-03-05,5,5
Puerto Rico,2020-03-12,0,0,0,0,2933408,2020-03-06,5,5
Puerto Rico,2020-03-13,0,0,0,0,2933408,2020-03-07,5,5
Puerto Rico,2020-03-14,0,0,0,0,2933408,2020-03-08,5,5
Puerto Rico,2020-03-15,0,0,0,0,2933408,2020-03-09,5,5
Puerto Rico,2020-03-16,5,0,5,0,2933408,2020-03-10,30,12.2474487139159
Puerto Rico,2020-03-17,0,0,5,0,2933408,2020-03-11,5.36416572167347,2.18991148563805
Puerto Rico,2020-03-18,0,0,5,0,2933408,2020-03-12,2.84523442934296,1.16156209174819
Puerto Rico,2020-03-19,0,0,5,0,2933408,2020-03-13,2.18221065982283,0.89088377130469
Puerto Rico,2020-03-20,9,0,14,0,2933408,2020-03-14,4.65166294452565,1.20105420775453
Puerto Rico,2020-03-21,7,1,21,1,2933408,2020-03-15,4.19397381897285,0.894158222581688
Puerto Rico,2020-03-22,2,0,23,1,2933408,2020-03-16,2.7891472501577,0.569332298364434
Puerto Rico,2020-03-23,8,1,31,2,2933408,2020-03-17,2.2988567031169,0.442415178790973
Puerto Rico,2020-03-24,8,0,39,2,2933408,2020-03-18,2.39183182857128,0.404293369302421
Puerto Rico,2020-03-25,12,0,51,2,2933408,2020-03-19,2.54965455691061,0.371905340266334
Puerto Rico,2020-03-26,13,0,64,2,2933408,2020-03-20,2.50405121032881,0.323271621188467
Puerto Rico,2020-03-27,15,1,79,3,2933408,2020-03-21,2.12126673201227,0.261109884808246
Puerto Rico,2020-03-28,21,0,100,3,2933408,2020-03-22,2.0955220672558,0.234286489536743
Puerto Rico,2020-03-29,27,0,127,3,2933408,2020-03-23,2.27221106023524,0.221745093943803
Puerto Rico,2020-03-30,47,3,174,6,2933408,2020-03-24,2.49811644866961,0.208176370722467
Puerto Rico,2020-03-31,65,2,239,8,2933408,2020-03-25,2.68946281220081,0.189700080360058
Puerto Rico,2020-04-01,47,3,286,11,2933408,2020-03-26,2.35986433785112,0.15361408410366
Puerto Rico,2020-04-02,30,1,316,12,2933408,2020-03-27,1.97381081575206,0.124092422785622
Puerto Rico,2020-04-03,0,3,316,15,2933408,2020-03-28,1.54982832896849,0.1004604493704
Puerto Rico,2020-04-04,136,3,452,18,2933408,2020-03-29,2.07136521647707,0.110247646291592
Puerto Rico,2020-04-05,23,2,475,20,2933408,2020-03-30,1.71620855156535,0.0918665375607377
Puerto Rico,2020-04-06,38,1,513,21,2933408,2020-03-31,1.44621272374435,0.0784318970662567
Puerto Rico,2020-04-07,60,2,573,23,2933408,2020-04-01,1.31236159136235,0.0717019732962522
Puerto Rico,2020-04-08,47,1,620,24,2933408,2020-04-02,1.24348958794153,0.0679390937799349
Puerto Rico,2020-04-09,63,9,683,33,2933408,2020-04-03,1.31149485833392,0.0683663954810909
Puerto Rico,2020-04-10,42,6,725,39,2933408,2020-04-04,1.38568845820811,0.0684342750953943
Puerto Rico,2020-04-11,63,3,788,42,2933408,2020-04-05,1.06076640328302,0.0577836279815671
Puerto Rico,2020-04-12,109,2,897,44,2933408,2020-04-06,1.30941260844763,0.0636658196661499
Puerto Rico,2020-04-13,6,1,903,45,2933408,2020-04-07,1.15671178455354,0.0584974293383434
Puerto Rico,2020-04-14,20,0,923,45,2933408,2020-04-08,1.00149002249212,0.0534555827852926
Puerto Rico,2020-04-15,51,6,974,51,2933408,2020-04-09,1.01605803953169,0.0539267614898225
Puerto Rico,2020-04-16,69,5,1043,56,2933408,2020-04-10,1.03795300848682,0.0546291057098328
Puerto Rico,2020-04-17,25,2,1068,58,2933408,2020-04-11,0.985022364258472,0.0531088466026992
Puerto Rico,2020-04-18,50,2,1118,60,2933408,2020-04-12,0.951509501843787,0.0522996921683422
Puerto Rico,2020-04-19,95,2,1213,62,2933408,2020-04-13,0.922798660470913,0.0518295364120747
Puerto Rico,2020-04-20,39,1,1252,63,2933408,2020-04-14,1.03738198501617,0.0554503995305996
Puerto Rico,2020-04-21,46,1,1298,64,2933408,2020-04-15,1.11107559524156,0.0572993487565891
Puerto Rico,2020-04-22,-46,-1,1252,63,2933408,2020-04-16,0.938476236044745,0.0520572952286735
Puerto Rico,2020-04-23,164,6,1416,69,2933408,2020-04-17,1.22174011884746,0.0596148135553691
Puerto Rico,2020-04-24,-140,8,1276,77,2933408,2020-04-18,1.11069524515981,0.0558851427827615
Puerto Rico,2020-04-25,31,6,1307,83,2933408,2020-04-19,1.02541804235122,0.0528818977589072
Puerto Rico,2020-04-26,64,1,1371,84,2933408,2020-04-20,0.937059271463787,0.0504495752911912
Puerto Rico,2020-04-27,18,0,1389,84,2933408,2020-04-21,0.89290875355451,0.0496060418641395
Puerto Rico,2020-04-28,11,2,1400,86,2933408,2020-04-22,0.816997571759625,0.0480586806917427
Puerto Rico,2020-04-29,33,0,1433,86,2933408,2020-04-23,0.946984606971174,0.0527733889109269
Puerto Rico,2020-04-30,106,6,1539,92,2933408,2020-04-24,0.789760784596019,0.0486064162464658
Puerto Rico,2020-05-01,36,2,1575,94,2933408,2020-04-25,0.931526085824039,0.0537816836407667
Puerto Rico,2020-05-02,182,1,1757,95,2933408,2020-04-26,1.43043068703923,0.0673563503973812
Puerto Rico,2020-05-03,51,2,1808,97,2933408,2020-04-27,1.28411133932685,0.0613572131604871
Puerto Rico,2020-05-04,35,0,1843,97,2933408,2020-04-28,1.24198909558901,0.0582253468758892
Puerto Rico,2020-05-05,81,2,1924,99,2933408,2020-04-29,1.36620487706558,0.0596260691806748
Puerto Rico,2020-05-06,44,0,1968,99,2933408,2020-04-30,1.30245403832517,0.0562574459740026
Puerto Rico,2020-05-07,63,3,2031,102,2933408,2020-05-01,1.12536042539383,0.0506836845183349
Puerto Rico,2020-05-08,125,5,2156,107,2933408,2020-05-02,1.29440611619938,0.0536548597552089
Puerto Rico,2020-05-09,17,1,2173,108,2933408,2020-05-03,0.883275089511265,0.0432541672283334
Puerto Rico,2020-05-10,25,3,2198,111,2933408,2020-05-04,0.840147862650681,0.0424881036792908
Rhode Island,2020-03-08,0,0,3,0,1059361,2020-03-02,1.5760132099008,0.909911650982632
Rhode Island,2020-03-09,0,0,3,0,1059361,2020-03-03,0.998879999182118,0.706314821013289
Rhode Island,2020-03-10,0,0,3,0,1059361,2020-03-04,1.10064828417792,0.778275865443547
Rhode Island,2020-03-11,2,0,5,0,1059361,2020-03-05,2.43623490610293,1.21811745305146
Rhode Island,2020-03-12,-2,0,3,0,1059361,2020-03-06,2.09914869305069,1.04957434652535
Rhode Island,2020-03-13,9,0,12,0,1059361,2020-03-07,5.83212305578637,1.61753990172719
Rhode Island,2020-03-14,8,0,20,0,1059361,2020-03-08,4.89613010762092,1.09480797473237
Rhode Island,2020-03-15,0,0,20,0,1059361,2020-03-09,2.73892208221769,0.612441596091403
Rhode Island,2020-03-16,1,0,21,0,1059361,2020-03-10,2.10913690363263,0.460251405329586
Rhode Island,2020-03-17,2,0,23,0,1059361,2020-03-11,1.91930608759231,0.400202984250487
Rhode Island,2020-03-18,10,0,33,0,1059361,2020-03-12,2.22242139870527,0.399158666545228
Rhode Island,2020-03-19,11,0,44,0,1059361,2020-03-13,2.46483149423179,0.380331756652034
Rhode Island,2020-03-20,10,0,54,0,1059361,2020-03-14,1.96606825444844,0.299822597979706
Rhode Island,2020-03-21,12,0,66,0,1059361,2020-03-15,1.79200802429473,0.261391235227909
Rhode Island,2020-03-22,17,0,83,0,1059361,2020-03-16,2.12562071212513,0.265702589015641
Rhode Island,2020-03-23,23,0,106,0,1059361,2020-03-17,2.36150850901808,0.254648011470937
Rhode Island,2020-03-24,18,0,124,0,1059361,2020-03-18,2.20668009406056,0.21849388732696
Rhode Island,2020-03-25,8,0,132,0,1059361,2020-03-19,1.73647580190744,0.173647580190744
Rhode Island,2020-03-26,33,0,165,0,1059361,2020-03-20,1.83901544723535,0.166496635499168
Rhode Island,2020-03-27,38,0,203,0,1059361,2020-03-21,1.9581038472964,0.159878509641894
Rhode Island,2020-03-28,36,2,239,2,1059361,2020-03-22,1.91253639074526,0.144989009609744
Rhode Island,2020-03-29,55,1,294,3,1059361,2020-03-23,1.96965341336295,0.135276351821497
Rhode Island,2020-03-30,114,1,408,4,1059361,2020-03-24,2.36397111886801,0.135806592368824
Rhode Island,2020-03-31,80,4,488,8,1059361,2020-03-25,2.2487326415996,0.117704046012271
Rhode Island,2020-04-01,78,2,566,10,1059361,2020-03-26,2.12929381694197,0.102091824330341
Rhode Island,2020-04-02,79,2,645,12,1059361,2020-03-27,1.91763326401444,0.0874365506246952
Rhode Island,2020-04-03,66,2,711,14,1059361,2020-03-28,1.71109927504494,0.0758431419371486
Rhode Island,2020-04-04,95,3,806,17,1059361,2020-03-29,1.67303973918649,0.0701991880407429
Rhode Island,2020-04-05,116,8,922,25,1059361,2020-03-30,1.64084216162793,0.0654246614550785
Rhode Island,2020-04-06,160,2,1082,27,1059361,2020-03-31,1.56496744180275,0.0602356249198543
Rhode Island,2020-04-07,147,3,1229,30,1059361,2020-04-01,1.54827114108498,0.0568388217041642
Rhode Island,2020-04-08,221,5,1450,35,1059361,2020-04-02,1.66974752213772,0.0561279489448125
Rhode Island,2020-04-09,277,8,1727,43,1059361,2020-04-03,1.80947657011891,0.0549843044658144
Rhode Island,2020-04-10,0,0,1727,43,1059361,2020-04-04,1.46406489942089,0.045909213451772
Rhode Island,2020-04-11,622,13,2349,56,1059361,2020-04-05,2.01891216293921,0.0513799617302203
Rhode Island,2020-04-12,316,7,2665,63,1059361,2020-04-06,1.92222111042582,0.0460288476393209
Rhode Island,2020-04-13,0,0,2665,63,1059361,2020-04-07,1.4594661255513,0.0366704661567226
Rhode Island,2020-04-14,586,17,3251,80,1059361,2020-04-08,1.69602522350357,0.0377080752830519
Rhode Island,2020-04-15,0,0,3251,80,1059361,2020-04-09,1.34322550138386,0.0316425543732329
Rhode Island,2020-04-16,278,7,3529,87,1059361,2020-04-10,1.24792496770569,0.0293893926048744
Rhode Island,2020-04-17,648,31,4177,118,1059361,2020-04-11,1.62994294148425,0.032923101881393
Rhode Island,2020-04-18,314,19,4491,137,1059361,2020-04-12,1.28010329185905,0.0276524699387534
Rhode Island,2020-04-19,215,13,4706,150,1059361,2020-04-13,1.14198614834599,0.0252716132904628
Rhode Island,2020-04-20,384,5,5090,155,1059361,2020-04-14,1.32833930664003,0.0269689243900369
Rhode Island,2020-04-21,410,16,5500,171,1059361,2020-04-15,1.16725338873389,0.0246078620996602
Rhode Island,2020-04-22,341,10,5841,181,1059361,2020-04-16,1.29526134129909,0.0254462445811184
Rhode Island,2020-04-23,415,8,6256,189,1059361,2020-04-17,1.29760007011997,0.0248438373523454
Rhode Island,2020-04-24,443,13,6699,202,1059361,2020-04-18,1.13135707202151,0.0225237693131451
Rhode Island,2020-04-25,430,13,7129,215,1059361,2020-04-19,1.15118420727779,0.022409136804212
Rhode Island,2020-04-26,310,11,7439,226,1059361,2020-04-20,1.16475420237153,0.0222758882701266
Rhode Island,2020-04-27,269,7,7708,233,1059361,2020-04-21,1.08242623654407,0.0211509832450711
Rhode Island,2020-04-28,219,6,7927,239,1059361,2020-04-22,0.98732544961948,0.0200371518964862
Rhode Island,2020-04-29,320,12,8247,251,1059361,2020-04-23,0.983606151527734,0.0200485602967457
Rhode Island,2020-04-30,374,15,8621,266,1059361,2020-04-24,0.974829600245984,0.0200410899703641
Rhode Island,2020-05-01,341,13,8962,279,1059361,2020-04-25,0.939648658131033,0.0197481895301976
Rhode Island,2020-05-02,327,17,9289,296,1059361,2020-04-26,0.909031431234924,0.0195547161599631
Rhode Island,2020-05-03,188,24,9477,320,1059361,2020-04-27,0.875162100841642,0.0193811654620855
Rhode Island,2020-05-04,175,21,9652,341,1059361,2020-04-28,0.857467764410711,0.0194427637625605
Rhode Island,2020-05-05,281,14,9933,355,1059361,2020-04-29,0.912296975436031,0.0203639746995862
Rhode Island,2020-05-06,272,15,10205,370,1059361,2020-04-30,0.908276269070502,0.0205211053219067
Rhode Island,2020-05-07,325,18,10530,388,1059361,2020-05-01,0.900543189763607,0.0206057232509837
Rhode Island,2020-05-08,249,11,10779,399,1059361,2020-05-02,0.874012893166768,0.0204984441898252
Rhode Island,2020-05-09,210,19,10989,418,1059361,2020-05-03,0.838235581525313,0.0203242222356882
Rhode Island,2020-05-10,285,4,11274,422,1059361,2020-05-04,0.915430340276005,0.021588897209024
South Carolina,2020-03-08,0,0,2,0,5148714,2020-03-02,5.28714977316387,3.05253734478203
South Carolina,2020-03-09,1,0,3,0,5148714,2020-03-03,4.15146309564454,2.07573154782227
South Carolina,2020-03-10,4,0,7,0,5148714,2020-03-04,5.69999949475294,2.01525414774985
South Carolina,2020-03-11,3,0,10,0,5148714,2020-03-05,4.35394207948831,1.31276293060022
South Carolina,2020-03-12,-3,0,7,0,5148714,2020-03-06,2.65382717745285,0.800159000550821
South Carolina,2020-03-13,1,0,8,0,5148714,2020-03-07,2.19658980403552,0.634100857329547
South Carolina,2020-03-14,11,0,19,0,5148714,2020-03-08,3.19243983609941,0.69664748573895
South Carolina,2020-03-15,0,0,19,0,5148714,2020-03-09,2.29702794043232,0.501252590974268
South Carolina,2020-03-16,11,1,30,1,5148714,2020-03-10,2.66916042124303,0.479395363615267
South Carolina,2020-03-17,17,0,47,1,5148714,2020-03-11,2.90456250603614,0.437879273302558
South Carolina,2020-03-18,13,0,60,1,5148714,2020-03-12,2.59502429260783,0.353138077056448
South Carolina,2020-03-19,20,0,80,1,5148714,2020-03-13,2.68918622019811,0.312611548240447
South Carolina,2020-03-20,46,2,126,3,5148714,2020-03-14,3.25133391188604,0.298049291036278
South Carolina,2020-03-21,48,0,174,3,5148714,2020-03-15,2.95810245609484,0.23683774253038
South Carolina,2020-03-22,22,0,196,3,5148714,2020-03-16,2.40440261807985,0.180217595535546
South Carolina,2020-03-23,102,2,298,5,5148714,2020-03-17,2.817862899809,0.171808133261266
South Carolina,2020-03-24,44,0,342,5,5148714,2020-03-18,2.29546678932247,0.133421297036796
South Carolina,2020-03-25,82,2,424,7,5148714,2020-03-19,2.22153882679143,0.116280656690563
South Carolina,2020-03-26,0,2,424,9,5148714,2020-03-20,1.69433623791837,0.0912199966496566
South Carolina,2020-03-27,118,4,542,13,5148714,2020-03-21,1.78673838190954,0.0874969550054444
South Carolina,2020-03-28,118,2,660,15,5148714,2020-03-22,1.82445567109124,0.0826739780360538
South Carolina,2020-03-29,114,1,774,16,5148714,2020-03-23,1.86569656411763,0.0775357031734294
South Carolina,2020-03-30,151,2,925,18,5148714,2020-03-24,1.72802433191955,0.0689556777672961
South Carolina,2020-03-31,158,4,1083,22,5148714,2020-03-25,1.77911551546368,0.0653133852922485
South Carolina,2020-04-01,210,4,1293,26,5148714,2020-03-26,1.81214941855976,0.0614376191916521
South Carolina,2020-04-02,261,5,1554,31,5148714,2020-03-27,2.02822454014993,0.0603093615047959
South Carolina,2020-04-03,146,3,1700,34,5148714,2020-03-28,1.72928258281692,0.0507953841770711
South Carolina,2020-04-04,217,6,1917,40,5148714,2020-03-29,1.62523515866011,0.0458221949066297
South Carolina,2020-04-05,132,4,2049,44,5148714,2020-03-30,1.47047420716741,0.0411653748073389
South Carolina,2020-04-06,183,4,2232,48,5148714,2020-03-31,1.37956876593536,0.0381451635399111
South Carolina,2020-04-07,185,3,2417,51,5148714,2020-04-01,1.31456802934709,0.035978448644675
South Carolina,2020-04-08,0,0,2417,51,5148714,2020-04-02,1.04665376586902,0.0312051862585236
South Carolina,2020-04-09,376,16,2793,67,5148714,2020-04-03,1.14379758156741,0.032481668621719
South Carolina,2020-04-10,274,5,3067,72,5148714,2020-04-04,1.24228168279824,0.0335874500047077
South Carolina,2020-04-11,144,8,3211,80,5148714,2020-04-05,1.12528618285723,0.0312700159012249
South Carolina,2020-04-12,109,2,3320,82,5148714,2020-04-06,1.07601247607378,0.0301698917018904
South Carolina,2020-04-13,71,0,3391,82,5148714,2020-04-07,0.970304010143406,0.0284891066916204
South Carolina,2020-04-14,162,15,3553,97,5148714,2020-04-08,0.9586805946406,0.0284311027077555
South Carolina,2020-04-15,103,9,3656,106,5148714,2020-04-09,1.06008993069477,0.0301045310752124
South Carolina,2020-04-16,275,5,3931,111,5148714,2020-04-10,0.966571015623872,0.0286399269463266
South Carolina,2020-04-17,168,5,4099,116,5148714,2020-04-11,0.87991928986177,0.0273774300361301
South Carolina,2020-04-18,149,3,4248,119,5148714,2020-04-12,0.907790893685432,0.0281765064728002
South Carolina,2020-04-19,129,1,4377,120,5148714,2020-04-13,0.947031619231535,0.0291153252155085
South Carolina,2020-04-20,69,3,4446,123,5148714,2020-04-14,0.956511663115609,0.0294346116880054
South Carolina,2020-04-21,-7,1,4439,124,5148714,2020-04-15,0.816379403123731,0.0273038116719496
South Carolina,2020-04-22,322,16,4761,140,5148714,2020-04-16,1.05214401411742,0.0315375249106059
South Carolina,2020-04-23,156,10,4917,150,5148714,2020-04-17,0.937692092052746,0.0297417871506699
South Carolina,2020-04-24,153,7,5070,157,5148714,2020-04-18,0.92704721408478,0.0296285574555562
South Carolina,2020-04-25,183,9,5253,166,5148714,2020-04-19,0.975406040882475,0.0306464883850607
South Carolina,2020-04-26,245,8,5498,174,5148714,2020-04-20,1.0936239305597,0.032547754674637
South Carolina,2020-04-27,115,3,5613,177,5148714,2020-04-21,1.11766928503289,0.0326057641517561
South Carolina,2020-04-28,122,15,5735,192,5148714,2020-04-22,1.20092867381045,0.033346267236563
South Carolina,2020-04-29,147,39,5882,231,5148714,2020-04-23,0.998241051874552,0.0298015599378706
South Carolina,2020-04-30,213,13,6095,244,5148714,2020-04-24,1.04257102223275,0.0303632843827333
South Carolina,2020-05-01,163,12,6258,256,5148714,2020-04-25,1.04898323238709,0.0304212894919987
South Carolina,2020-05-02,231,11,6489,267,5148714,2020-04-26,1.08086351194733,0.0307316590471835
South Carolina,2020-05-03,137,8,6626,275,5148714,2020-04-27,0.971790989736909,0.0289218385270631
South Carolina,2020-05-04,131,8,6757,283,5148714,2020-04-28,0.988878838210264,0.0292240458009879
South Carolina,2020-05-05,84,13,6841,296,5148714,2020-04-29,0.962032157423836,0.0289145061307557
South Carolina,2020-05-06,95,9,6936,305,5148714,2020-04-30,0.924041840868027,0.0284488952912696
South Carolina,2020-05-07,206,11,7142,316,5148714,2020-05-01,0.932950412778896,0.0288189344946145
South Carolina,2020-05-08,225,4,7367,320,5148714,2020-05-02,1.0036303272288,0.030123975572031
South Carolina,2020-05-09,164,10,7531,330,5148714,2020-05-03,0.943797745967552,0.0292238063636988
South Carolina,2020-05-10,122,1,7653,331,5148714,2020-05-04,0.937938259174866,0.0292534905633508
South Dakota,2020-03-08,0,0,0,0,884659,2020-03-02,5,5
South Dakota,2020-03-09,0,0,0,0,884659,2020-03-03,5,5
South Dakota,2020-03-10,0,0,0,0,884659,2020-03-04,5,5
South Dakota,2020-03-11,8,1,8,1,884659,2020-03-05,45,15
South Dakota,2020-03-12,-1,0,7,1,884659,2020-03-06,5.39033874298553,1.79677958099517
South Dakota,2020-03-13,1,0,8,1,884659,2020-03-07,3.07308132372949,0.971793641791045
South Dakota,2020-03-14,0,0,8,1,884659,2020-03-08,2.24068778999162,0.708567694170255
South Dakota,2020-03-15,0,0,8,1,884659,2020-03-09,1.844609010087,0.583316586434341
South Dakota,2020-03-16,2,0,10,1,884659,2020-03-10,1.95518749772892,0.564414014064992
South Dakota,2020-03-17,1,0,11,1,884659,2020-03-11,1.84001382769042,0.510328015638505
South Dakota,2020-03-18,0,0,11,1,884659,2020-03-12,0.617932445917757,0.276347790914963
South Dakota,2020-03-19,3,0,14,1,884659,2020-03-13,1.07581611915437,0.380358436581926
South Dakota,2020-03-20,0,0,14,1,884659,2020-03-14,0.998041446175644,0.377224209245144
South Dakota,2020-03-21,0,0,14,1,884659,2020-03-15,1.01739508589979,0.384539197484292
South Dakota,2020-03-22,7,0,21,1,884659,2020-03-16,2.09182756998351,0.559064434220442
South Dakota,2020-03-23,7,0,28,1,884659,2020-03-17,2.4170818914824,0.554516615959681
South Dakota,2020-03-24,2,0,30,1,884659,2020-03-18,1.98376459084396,0.443583247648414
South Dakota,2020-03-25,11,0,41,1,884659,2020-03-19,2.56392808697672,0.460495078436384
South Dakota,2020-03-26,5,0,46,1,884659,2020-03-20,2.11965493758688,0.368984562970045
South Dakota,2020-03-27,12,0,58,1,884659,2020-03-21,2.34420891345551,0.349454032263163
South Dakota,2020-03-28,10,0,68,1,884659,2020-03-22,2.28711388863031,0.308394373830465
South Dakota,2020-03-29,22,0,90,1,884659,2020-03-23,2.31547471410034,0.27675216224831
South Dakota,2020-03-30,11,0,101,1,884659,2020-03-24,1.94523535348167,0.226129016643243
South Dakota,2020-03-31,7,0,108,1,884659,2020-03-25,1.74039238331957,0.195809441333666
South Dakota,2020-04-01,21,1,129,2,884659,2020-03-26,1.71672164463003,0.181972130386887
South Dakota,2020-04-02,36,0,165,2,884659,2020-03-27,2.03935685565695,0.186166958774353
South Dakota,2020-04-03,22,0,187,2,884659,2020-03-28,1.84562883502195,0.161872357042029
South Dakota,2020-04-04,25,0,212,2,884659,2020-03-29,1.7513590425229,0.145442452082501
South Dakota,2020-04-05,28,0,240,2,884659,2020-03-30,1.59046795183901,0.129430446325199
South Dakota,2020-04-06,48,2,288,4,884659,2020-03-31,1.77366284114546,0.129357657621907
South Dakota,2020-04-07,32,2,320,6,884659,2020-04-01,1.75506527962195,0.120255091460726
South Dakota,2020-04-08,73,0,393,6,884659,2020-04-02,1.8950832551006,0.116414038960209
South Dakota,2020-04-09,54,0,447,6,884659,2020-04-03,1.72273832634,0.102406163908743
South Dakota,2020-04-10,89,0,536,6,884659,2020-04-04,1.85403927129369,0.0991025676400713
South Dakota,2020-04-11,90,0,626,6,884659,2020-04-05,1.88804485839202,0.0926804769774757
South Dakota,2020-04-12,104,0,730,6,884659,2020-04-06,1.89555302293915,0.0855451103919027
South Dakota,2020-04-13,138,0,868,6,884659,2020-04-07,1.90217225174397,0.0789154024841387
South Dakota,2020-04-14,120,0,988,6,884659,2020-04-08,1.85569989494873,0.0717455029252989
South Dakota,2020-04-15,180,0,1168,6,884659,2020-04-09,1.83690251002355,0.0659409571828406
South Dakota,2020-04-16,143,1,1311,7,884659,2020-04-10,1.75543170276127,0.0596864685147985
South Dakota,2020-04-17,100,0,1411,7,884659,2020-04-11,1.54398550941677,0.0521664360210041
South Dakota,2020-04-18,131,0,1542,7,884659,2020-04-12,1.45651896358349,0.0480984936779478
South Dakota,2020-04-19,93,0,1635,7,884659,2020-04-13,1.32485279820089,0.0440152860375538
South Dakota,2020-04-20,50,0,1685,7,884659,2020-04-14,1.12638315327367,0.0393830633918387
South Dakota,2020-04-21,70,1,1755,8,884659,2020-04-15,1.03502309804394,0.037348179017072
South Dakota,2020-04-22,103,1,1858,9,884659,2020-04-16,0.932282777619457,0.0354657082995583
South Dakota,2020-04-23,98,0,1956,9,884659,2020-04-17,0.888828680324374,0.0349704966974743
South Dakota,2020-04-24,84,1,2040,10,884659,2020-04-18,0.892844504400236,0.0355717765115383
South Dakota,2020-04-25,107,0,2147,10,884659,2020-04-19,0.882476392245249,0.0358481529613854
South Dakota,2020-04-26,65,1,2212,11,884659,2020-04-20,0.864217577543699,0.035946712323633
South Dakota,2020-04-27,32,0,2244,11,884659,2020-04-21,0.862233857611833,0.0364360306665811
South Dakota,2020-04-28,69,0,2313,11,884659,2020-04-22,0.886584150998949,0.0374985141459365
South Dakota,2020-04-29,60,2,2373,13,884659,2020-04-23,0.838351922543383,0.0369063855011575
South Dakota,2020-04-30,76,4,2449,17,884659,2020-04-24,0.828237691168219,0.0372641754423753
South Dakota,2020-05-01,76,4,2525,21,884659,2020-04-25,0.844833636291475,0.0383224319713737
South Dakota,2020-05-02,63,0,2588,21,884659,2020-04-26,0.793400884872756,0.0377382316353224
South Dakota,2020-05-03,43,0,2631,21,884659,2020-04-27,0.784975045486249,0.0383028602076404
South Dakota,2020-05-04,37,0,2668,21,884659,2020-04-28,0.830742633221764,0.0402969367585539
South Dakota,2020-05-05,53,3,2721,24,884659,2020-04-29,0.827877052838986,0.0409358856628971
South Dakota,2020-05-06,59,5,2780,29,884659,2020-04-30,0.853076877407959,0.0422335987067852
South Dakota,2020-05-07,126,2,2906,31,884659,2020-05-01,0.985579913425111,0.0460531249561308
South Dakota,2020-05-08,239,0,3145,31,884659,2020-05-02,1.34003271786443,0.0537736606343172
South Dakota,2020-05-09,248,3,3393,34,884659,2020-05-03,1.62844150039666,0.0573594054174539
South Dakota,2020-05-10,124,0,3517,34,884659,2020-05-04,1.58136021204856,0.053096879402762
Tennessee,2020-03-08,2,0,3,0,6829174,2020-03-02,5.6345878448971,2.81729392244855
Tennessee,2020-03-09,0,0,3,0,6829174,2020-03-03,3.41196747263421,1.70598373631711
Tennessee,2020-03-10,0,0,3,0,6829174,2020-03-04,2.43610115130762,1.21805057565381
Tennessee,2020-03-11,6,0,9,0,6829174,2020-03-05,5.11141691932152,1.61637195357771
Tennessee,2020-03-12,9,0,18,0,6829174,2020-03-06,5.46227574224757,1.28747073935135
Tennessee,2020-03-13,8,0,26,0,6829174,2020-03-07,4.23585998490891,0.830720489226822
Tennessee,2020-03-14,6,0,32,0,6829174,2020-03-08,3.16579690033593,0.559639114021723
Tennessee,2020-03-15,0,0,32,0,6829174,2020-03-09,2.06776093801928,0.377519769760401
Tennessee,2020-03-16,20,0,52,0,6829174,2020-03-10,2.83253494463903,0.400580933460424
Tennessee,2020-03-17,22,0,74,0,6829174,2020-03-11,3.06711632753446,0.361463125647933
Tennessee,2020-03-18,26,0,100,0,6829174,2020-03-12,2.77201002673178,0.289002023242157
Tennessee,2020-03-19,54,0,154,0,6829174,2020-03-13,3.03420446714519,0.25922958215839
Tennessee,2020-03-20,69,1,223,1,6829174,2020-03-14,3.1326843218483,0.222630180511349
Tennessee,2020-03-21,81,0,304,1,6829174,2020-03-15,3.02172535880987,0.182883138331525
Tennessee,2020-03-22,89,1,393,2,6829174,2020-03-16,2.8417242270388,0.149357709429847
Tennessee,2020-03-23,221,0,614,2,6829174,2020-03-17,3.21768881974947,0.135609415497139
Tennessee,2020-03-24,158,0,772,2,6829174,2020-03-18,2.77734596315906,0.105048872058926
Tennessee,2020-03-25,144,1,916,3,6829174,2020-03-19,2.36884263880801,0.082875313339497
Tennessee,2020-03-26,181,0,1097,3,6829174,2020-03-20,2.13983184025922,0.06964559424136
Tennessee,2020-03-27,221,3,1318,6,6829174,2020-03-21,2.02326521439016,0.0611149608339755
Tennessee,2020-03-28,193,1,1511,7,6829174,2020-03-22,1.85420641764033,0.0533487948002381
Tennessee,2020-03-29,209,1,1720,8,6829174,2020-03-23,1.74140377663169,0.0477859742213074
Tennessee,2020-03-30,197,6,1917,14,6829174,2020-03-24,1.49281845176209,0.0413397835866966
Tennessee,2020-03-31,474,9,2391,23,6829174,2020-03-25,1.68868974041184,0.0419558339163039
Tennessee,2020-04-01,542,1,2933,24,6829174,2020-03-26,1.86814688764307,0.041586315086611
Tennessee,2020-04-02,80,12,3013,36,6829174,2020-03-27,1.51415604957518,0.0345827543361989
Tennessee,2020-04-03,54,5,3067,41,6829174,2020-03-28,1.24360175363295,0.0297277678912105
Tennessee,2020-04-04,255,9,3322,50,6829174,2020-03-29,1.23234581567564,0.0289503286401686
Tennessee,2020-04-05,311,3,3633,53,6829174,2020-03-30,1.25621551386394,0.0287139662630233
Tennessee,2020-04-06,169,12,3802,65,6829174,2020-03-31,1.18369175193497,0.0272563550101724
Tennessee,2020-04-07,337,7,4139,72,6829174,2020-04-01,1.06059390471152,0.0253602903886014
Tennessee,2020-04-08,224,8,4363,80,6829174,2020-04-02,0.859623679415313,0.022724197402706
Tennessee,2020-04-09,271,14,4634,94,6829174,2020-04-03,1.00585127709983,0.0249751638858316
Tennessee,2020-04-10,257,4,4891,98,6829174,2020-04-04,1.14455592703884,0.0267920277461513
Tennessee,2020-04-11,241,8,5132,106,6829174,2020-04-05,1.10535369108813,0.0259741916508918
Tennessee,2020-04-12,376,0,5508,106,6829174,2020-04-06,1.11745750488723,0.0257996966481563
Tennessee,2020-04-13,102,3,5610,109,6829174,2020-04-07,1.05407096909029,0.0247828112283886
Tennessee,2020-04-14,217,15,5827,124,6829174,2020-04-08,0.972805186056287,0.0236706973362605
Tennessee,2020-04-15,0,0,5827,124,6829174,2020-04-09,0.849486972909146,0.0221941190307497
Tennessee,2020-04-16,339,12,6166,136,6829174,2020-04-10,0.918199300892539,0.0234512437294685
Tennessee,2020-04-17,97,5,6263,141,6829174,2020-04-11,0.841941151068012,0.0227219954311712
Tennessee,2020-04-18,326,1,6589,142,6829174,2020-04-12,0.921745214114536,0.0241397144972828
Tennessee,2020-04-19,481,6,7070,148,6829174,2020-04-13,1.00825396687129,0.0255029518158009
Tennessee,2020-04-20,168,4,7238,152,6829174,2020-04-14,1.04842814069501,0.0259763499913135
Tennessee,2020-04-21,156,5,7394,157,6829174,2020-04-15,0.996921430869463,0.0251760680027855
Tennessee,2020-04-22,0,0,7394,157,6829174,2020-04-16,0.994365912319232,0.0251115314136313
Tennessee,2020-04-23,872,14,8266,171,6829174,2020-04-17,1.33475083121505,0.0291197185967084
Tennessee,2020-04-24,462,-2,8728,169,6829174,2020-04-18,1.47602500624021,0.0297233105525842
Tennessee,2020-04-25,461,8,9189,177,6829174,2020-04-19,1.41176347161199,0.0276816366982743
Tennessee,2020-04-26,478,4,9667,181,6829174,2020-04-20,1.29446402543596,0.0253962978604083
Tennessee,2020-04-27,251,3,9918,184,6829174,2020-04-21,1.25869174121747,0.0243092172906697
Tennessee,2020-04-28,134,4,10052,188,6829174,2020-04-22,1.18955467375738,0.0230688124913774
Tennessee,2020-04-29,314,7,10366,195,6829174,2020-04-23,1.28283614476437,0.0235273890124179
Tennessee,2020-04-30,369,4,10735,199,6829174,2020-04-24,1.01361127892096,0.0203949646952716
Tennessee,2020-05-01,1156,5,11891,204,6829174,2020-04-25,1.28820285267661,0.0229016102374442
Tennessee,2020-05-02,770,5,12661,209,6829174,2020-04-26,1.35437701573684,0.0229819662945591
Tennessee,2020-05-03,516,1,13177,210,6829174,2020-04-27,1.27373226140294,0.0214962514781061
Tennessee,2020-05-04,394,9,13571,219,6829174,2020-04-28,1.25328469160065,0.020733158293395
Tennessee,2020-05-05,119,7,13690,226,6829174,2020-04-29,1.18995963883943,0.0197260987732775
Tennessee,2020-05-06,248,13,13938,239,6829174,2020-04-30,1.12628145650876,0.0188421486489261
Tennessee,2020-05-07,158,-1,14096,238,6829174,2020-05-01,1.03584626967241,0.0178647297939549
Tennessee,2020-05-08,345,4,14441,242,6829174,2020-05-02,0.782111410205233,0.015485077830821
Tennessee,2020-05-09,327,0,14768,242,6829174,2020-05-03,0.676272573136311,0.0147294479913276
Tennessee,2020-05-10,217,1,14985,243,6829174,2020-05-04,0.626783503676752,0.0147366332136963
Texas,2020-03-08,3,0,11,0,28995881,2020-03-02,4.21601742289468,1.2170593970082
Texas,2020-03-09,2,0,13,0,28995881,2020-03-03,3.04159730135199,0.812901072156812
Texas,2020-03-10,3,0,16,0,28995881,2020-03-04,2.65933371432512,0.644983164584036
Texas,2020-03-11,5,0,21,0,28995881,2020-03-05,2.63399820771624,0.561570304764497
Texas,2020-03-12,6,0,27,0,28995881,2020-03-06,2.29389428324007,0.458778856648014
Texas,2020-03-13,17,0,44,0,28995881,2020-03-07,3.00865345044729,0.469872727575488
Texas,2020-03-14,16,0,60,0,28995881,2020-03-08,2.83050109258542,0.388799226334913
Texas,2020-03-15,3,0,63,0,28995881,2020-03-09,2.06294245212186,0.28336693861715
Texas,2020-03-16,22,0,85,0,28995881,2020-03-10,2.32763732583971,0.272429342872814
Texas,2020-03-17,25,1,110,1,28995881,2020-03-11,2.43052435638224,0.249366537386388
Texas,2020-03-18,86,2,196,3,28995881,2020-03-12,3.50558102778786,0.264243112303654
Texas,2020-03-19,110,2,306,5,28995881,2020-03-13,3.75992840855637,0.224698700147785
Texas,2020-03-20,123,-1,429,4,28995881,2020-03-14,3.31862130211793,0.16891337684714
Texas,2020-03-21,153,1,582,5,28995881,2020-03-15,3.04201777737816,0.133018149956135
Texas,2020-03-22,61,2,643,7,28995881,2020-03-16,2.38900699012991,0.0991127107393524
Texas,2020-03-23,115,2,758,9,28995881,2020-03-17,2.14862341585095,0.0827618816551939
Texas,2020-03-24,197,3,955,12,28995881,2020-03-18,2.19792902692343,0.0755663565379247
Texas,2020-03-25,274,3,1229,15,28995881,2020-03-19,2.1760822725633,0.0676729395515493
Texas,2020-03-26,334,6,1563,21,28995881,2020-03-20,2.14265833910863,0.0604105242923091
Texas,2020-03-27,374,5,1937,26,28995881,2020-03-21,2.09165071434187,0.0538448961077104
Texas,2020-03-28,518,4,2455,30,28995881,2020-03-22,2.13100308995768,0.049226537132552
Texas,2020-03-29,337,7,2792,37,28995881,2020-03-23,1.9958786891263,0.0430442268052264
Texas,2020-03-30,355,8,3147,45,28995881,2020-03-24,1.84518277522862,0.0377433497370405
Texas,2020-03-31,662,9,3809,54,28995881,2020-03-25,1.88496669385694,0.035277729399384
Texas,2020-04-01,546,12,4355,66,28995881,2020-03-26,1.76037453513558,0.0314804648739066
Texas,2020-04-02,714,11,5069,77,28995881,2020-03-27,1.71114785400514,0.0288947974211884
Texas,2020-04-03,665,23,5734,100,28995881,2020-03-28,1.62618610896363,0.0263871670671756
Texas,2020-04-04,833,16,6567,116,28995881,2020-03-29,1.56660065955424,0.0244274959692542
Texas,2020-04-05,642,20,7209,136,28995881,2020-03-30,1.51504888568281,0.0227936455509668
Texas,2020-04-06,834,14,8043,150,28995881,2020-03-31,1.52599732920664,0.0218066383694242
Texas,2020-04-07,882,10,8925,160,28995881,2020-04-01,1.44742517389238,0.020234310646613
Texas,2020-04-08,852,29,9777,189,28995881,2020-04-02,1.40866446902781,0.019128801400525
Texas,2020-04-09,1431,21,11208,210,28995881,2020-04-03,1.47867225100921,0.0188706881344721
Texas,2020-04-10,897,28,12105,238,28995881,2020-04-04,1.40598316835491,0.0176133610655467
Texas,2020-04-11,918,28,13023,266,28995881,2020-04-05,1.31660754695562,0.0163847925460537
Texas,2020-04-12,654,17,13677,283,28995881,2020-04-06,1.24255259730839,0.0154488517607687
Texas,2020-04-13,598,22,14275,305,28995881,2020-04-07,1.14520843459188,0.014505609257438
Texas,2020-04-14,731,37,15006,342,28995881,2020-04-08,1.08907746893976,0.0139648271782275
Texas,2020-04-15,901,33,15907,375,28995881,2020-04-09,1.08360668433039,0.0138390416789718
Texas,2020-04-16,969,39,16876,414,28995881,2020-04-10,0.989957490226202,0.0131481096557916
Texas,2020-04-17,973,37,17849,451,28995881,2020-04-11,1.00661991159084,0.0132806857436902
Texas,2020-04-18,855,25,18704,476,28995881,2020-04-12,0.999582132631363,0.0132607433541297
Texas,2020-04-19,556,14,19260,490,28995881,2020-04-13,0.984054275432148,0.0131688044225943
Texas,2020-04-20,491,17,19751,507,28995881,2020-04-14,0.969688363061587,0.0131027004776087
Texas,2020-04-21,823,26,20574,533,28995881,2020-04-15,0.99332378348719,0.0133107407573067
Texas,2020-04-22,747,23,21321,556,28995881,2020-04-16,0.968835142808267,0.0131659030642698
Texas,2020-04-23,1329,48,22650,604,28995881,2020-04-17,1.03926106538645,0.0136756715895342
Texas,2020-04-24,992,20,23642,624,28995881,2020-04-18,1.03683313124592,0.013621333333769
Texas,2020-04-25,511,14,24153,638,28995881,2020-04-19,0.966326529045999,0.0130895781832786
Texas,2020-04-26,814,13,24967,651,28995881,2020-04-20,1.01755669136847,0.0134684194202541
Texas,2020-04-27,354,15,25321,666,28995881,2020-04-21,0.992644335028686,0.0132992481386239
Texas,2020-04-28,1036,53,26357,719,28995881,2020-04-22,1.03063004665479,0.0135515401906961
Texas,2020-04-29,900,35,27257,754,28995881,2020-04-23,1.05291663417889,0.0136650259999268
Texas,2020-04-30,1470,58,28727,812,28995881,2020-04-24,1.06595526764717,0.0136728368680339
Texas,2020-05-01,965,28,29692,840,28995881,2020-04-25,1.04678380838042,0.0134568502612411
Texas,2020-05-02,1225,23,30917,863,28995881,2020-04-26,1.15843561150261,0.0140843886045768
Texas,2020-05-03,1081,15,31998,878,28995881,2020-04-27,1.16983476920828,0.013950349688616
Texas,2020-05-04,785,23,32783,901,28995881,2020-04-28,1.19733808418133,0.0138598993251526
Texas,2020-05-05,1129,24,33912,925,28995881,2020-04-29,1.16578275474507,0.0134113239174698
Texas,2020-05-06,1016,29,34928,954,28995881,2020-04-30,1.14404483264765,0.013061370437053
Texas,2020-05-07,1108,31,36036,985,28995881,2020-05-01,1.06017258843565,0.0123998914279168
Texas,2020-05-08,1210,40,37246,1025,28995881,2020-05-02,1.08255501683777,0.0124546848474775
Texas,2020-05-09,1148,41,38394,1066,28995881,2020-05-03,1.05811925916172,0.0122360681954971
Texas,2020-05-10,864,28,39258,1094,28995881,2020-05-04,1.01601946403399,0.0119235014675377
Utah,2020-03-08,0,0,1,0,3205958,2020-03-02,5.21231403354432,3.68566259879299
Utah,2020-03-09,0,0,1,0,3205958,2020-03-03,3.43785639752253,2.43093157143374
Utah,2020-03-10,1,0,2,0,3205958,2020-03-04,4.22594088367282,2.43984810676795
Utah,2020-03-11,1,0,3,0,3205958,2020-03-05,4.04597283690161,2.02298641845081
Utah,2020-03-12,0,0,3,0,3205958,2020-03-06,2.77024269074354,1.38512134537177
Utah,2020-03-13,6,0,9,0,3205958,2020-03-07,5.46967716208097,1.72966378979818
Utah,2020-03-14,1,0,10,0,3205958,2020-03-08,3.12470683741594,0.988119062653581
Utah,2020-03-15,8,0,18,0,3205958,2020-03-09,3.91739233622965,0.9233382285054
Utah,2020-03-16,10,0,28,0,3205958,2020-03-10,4.00238643471575,0.756379939788309
Utah,2020-03-17,11,0,39,0,3205958,2020-03-11,3.41805315654226,0.554481440554773
Utah,2020-03-18,8,0,47,0,3205958,2020-03-12,2.726221104226,0.406401047382926
Utah,2020-03-19,15,0,62,0,3205958,2020-03-13,2.69675473023182,0.348149538633131
Utah,2020-03-20,33,0,95,0,3205958,2020-03-14,2.94310219360239,0.315533675306974
Utah,2020-03-21,23,0,118,0,3205958,2020-03-15,2.67004790286193,0.255744206416077
Utah,2020-03-22,44,1,162,1,3205958,2020-03-16,2.64979240567177,0.220053281841808
Utah,2020-03-23,95,0,257,1,3205958,2020-03-17,3.16665408628727,0.20880298704968
Utah,2020-03-24,41,0,298,1,3205958,2020-03-18,2.51163879004067,0.155765225353328
Utah,2020-03-25,42,0,340,1,3205958,2020-03-19,2.14964039799725,0.125369573942062
Utah,2020-03-26,56,0,396,1,3205958,2020-03-20,1.9910693946942,0.108783741850558
Utah,2020-03-27,76,0,472,1,3205958,2020-03-21,1.87975701744161,0.0966842683019969
Utah,2020-03-28,130,0,602,1,3205958,2020-03-22,2.05589397735601,0.0933533366084764
Utah,2020-03-29,118,1,720,2,3205958,2020-03-23,1.96801479586467,0.083238156895759
Utah,2020-03-30,78,2,798,4,3205958,2020-03-24,1.59423370275769,0.0684782010592484
Utah,2020-03-31,90,1,888,5,3205958,2020-03-25,1.5479260290251,0.0636731686423996
Utah,2020-04-01,0,0,888,5,3205958,2020-03-26,1.30605674777291,0.0557411436667161
Utah,2020-04-02,198,2,1086,7,3205958,2020-03-27,1.55006519084361,0.0589672588869793
Utah,2020-04-03,162,0,1248,7,3205958,2020-03-28,1.59016799894387,0.0570469591936066
Utah,2020-04-04,180,1,1428,8,3205958,2020-03-29,1.5117887474002,0.0525700455943483
Utah,2020-04-05,173,0,1601,8,3205958,2020-03-30,1.46157598949678,0.0492138234948861
Utah,2020-04-06,77,5,1678,13,3205958,2020-03-31,1.33910585312889,0.0451156225019561
Utah,2020-04-07,61,0,1739,13,3205958,2020-04-01,1.21396114604879,0.0415896235720963
Utah,2020-04-08,109,0,1848,13,3205958,2020-04-02,1.31737111820371,0.0424958425227004
Utah,2020-04-09,8,0,1856,13,3205958,2020-04-03,1.00156275812266,0.0360704016623152
Utah,2020-04-10,247,4,2103,17,3205958,2020-04-04,1.10641052882805,0.0378163333509384
Utah,2020-04-11,104,1,2207,18,3205958,2020-04-05,1.00020961784551,0.0358132492248232
Utah,2020-04-12,96,0,2303,18,3205958,2020-04-06,0.90076122611238,0.0339728530747998
Utah,2020-04-13,60,-5,2363,13,3205958,2020-04-07,0.900496196733089,0.0343811045537572
Utah,2020-04-14,54,5,2417,18,3205958,2020-04-08,0.914884318828185,0.0351100377718155
Utah,2020-04-15,131,2,2548,20,3205958,2020-04-09,0.963735757097979,0.0363997971790765
Utah,2020-04-16,135,0,2683,20,3205958,2020-04-10,1.14890095931853,0.0399270683903191
Utah,2020-04-17,110,3,2793,23,3205958,2020-04-11,0.933099318097631,0.035496770963279
Utah,2020-04-18,124,2,2917,25,3205958,2020-04-12,0.964240433253037,0.036161841501222
Utah,2020-04-19,152,2,3069,27,3205958,2020-04-13,1.05413604739671,0.0380626466111057
Utah,2020-04-20,144,1,3213,28,3205958,2020-04-14,1.15892870077882,0.0397275642067478
Utah,2020-04-21,84,4,3297,32,3205958,2020-04-15,1.16222118000459,0.0391562264464377
Utah,2020-04-22,148,0,3445,32,3205958,2020-04-16,1.14363274579851,0.0381635190205793
Utah,2020-04-23,167,3,3612,35,3205958,2020-04-17,1.14999881998008,0.0377099468631998
Utah,2020-04-24,170,4,3782,39,3205958,2020-04-18,1.18910192205131,0.0377921399158651
Utah,2020-04-25,166,2,3948,41,3205958,2020-04-19,1.19538334512983,0.0372106581929546
Utah,2020-04-26,175,0,4123,41,3205958,2020-04-20,1.17551253759658,0.0361910376961338
Utah,2020-04-27,113,0,4236,41,3205958,2020-04-21,1.10216279757485,0.0344425874242141
Utah,2020-04-28,109,0,4345,41,3205958,2020-04-22,1.10643424856834,0.0341615735043713
Utah,2020-04-29,152,4,4497,45,3205958,2020-04-23,1.09095698954447,0.0336196697874224
Utah,2020-04-30,175,1,4672,46,3205958,2020-04-24,1.08085152691668,0.0331824423447179
Utah,2020-05-01,156,0,4828,46,3205958,2020-04-25,1.05125568851527,0.0324889007957289
Utah,2020-05-02,157,3,4985,49,3205958,2020-04-26,1.0326979549215,0.0320534396342777
Utah,2020-05-03,190,1,5175,50,3205958,2020-04-27,1.04262518973867,0.0321302442965225
Utah,2020-05-04,142,0,5317,50,3205958,2020-04-28,1.06434026185233,0.0323568965613682
Utah,2020-05-05,132,6,5449,56,3205958,2020-04-29,1.07438662448583,0.0323206029421892
Utah,2020-05-06,146,2,5595,58,3205958,2020-04-30,1.05319016380184,0.0317693221228091
Utah,2020-05-07,129,3,5724,61,3205958,2020-05-01,0.998356406576175,0.0307660274794733
Utah,2020-05-08,195,0,5919,61,3205958,2020-05-02,1.03592450704544,0.0313485016715128
Utah,2020-05-09,184,5,6103,66,3205958,2020-05-03,1.05717350611412,0.0316032122159734
Utah,2020-05-10,148,1,6251,67,3205958,2020-05-04,1.00620748089049,0.0306605322868244
Vermont,2020-03-08,1,0,1,0,623989,2020-03-02,10,7.07106781186548
Vermont,2020-03-09,0,0,1,0,623989,2020-03-03,5.21231403354432,3.68566259879299
Vermont,2020-03-10,0,0,1,0,623989,2020-03-04,3.43785639752253,2.43093157143374
Vermont,2020-03-11,0,0,1,0,623989,2020-03-05,2.81729392244855,1.99212763715902
Vermont,2020-03-12,1,0,2,0,623989,2020-03-06,3.72702916098785,2.15180128937392
Vermont,2020-03-13,0,0,2,0,623989,2020-03-07,2.82443602673013,1.63068890034152
Vermont,2020-03-14,3,0,5,0,623989,2020-03-08,4.55110761494285,1.85798190351749
Vermont,2020-03-15,0,0,5,0,623989,2020-03-09,2.44588554925406,1.0938332706633
Vermont,2020-03-16,7,0,12,0,623989,2020-03-10,4.63775140929967,1.33880351229686
Vermont,2020-03-17,0,0,12,0,623989,2020-03-11,2.88180571782231,0.831905653468456
Vermont,2020-03-18,1,0,13,0,623989,2020-03-12,2.24498157240148,0.622645859366562
Vermont,2020-03-19,9,2,22,2,623989,2020-03-13,2.9727046946736,0.648697346766302
Vermont,2020-03-20,7,0,29,2,623989,2020-03-14,2.93103546201181,0.553913636885326
Vermont,2020-03-21,20,0,49,2,623989,2020-03-15,3.41097751487931,0.508478506199562
Vermont,2020-03-22,3,0,52,2,623989,2020-03-16,2.48282910304802,0.358365512749154
Vermont,2020-03-23,23,3,75,5,623989,2020-03-17,2.52039250783576,0.315049063479469
Vermont,2020-03-24,20,2,95,7,623989,2020-03-18,2.56485126527152,0.279848215938333
Vermont,2020-03-25,30,1,125,8,623989,2020-03-19,2.63447028588261,0.247830117506627
Vermont,2020-03-26,33,1,158,9,623989,2020-03-20,2.41160561751367,0.206037372671556
Vermont,2020-03-27,26,1,184,10,623989,2020-03-21,2.13414245299109,0.170868145477262
Vermont,2020-03-28,27,2,211,12,623989,2020-03-22,1.81536511395348,0.142190369604764
Vermont,2020-03-29,24,0,235,12,623989,2020-03-23,1.76219155717526,0.129910485154783
Vermont,2020-03-30,21,0,256,12,623989,2020-03-24,1.52280609030132,0.112877897384322
Vermont,2020-03-31,37,1,293,13,623989,2020-03-25,1.50870616321754,0.106949344298515
Vermont,2020-04-01,28,3,321,16,623989,2020-03-26,1.36691302941568,0.0973885209359037
Vermont,2020-04-02,17,1,338,17,623989,2020-03-27,1.17284450257744,0.087176845322398
Vermont,2020-04-03,51,0,389,17,623989,2020-03-28,1.29593813736856,0.090292288478426
Vermont,2020-04-04,72,3,461,20,623989,2020-03-29,1.50806540699523,0.0951882444400799
Vermont,2020-04-05,51,2,512,22,623989,2020-03-30,1.5232652975945,0.0913593814089347
Vermont,2020-04-06,31,1,543,23,623989,2020-03-31,1.42539557407619,0.0839922396918805
Vermont,2020-04-07,32,0,575,23,623989,2020-04-01,1.28946340329868,0.0766506431148321
Vermont,2020-04-08,30,0,605,23,623989,2020-04-02,1.22913460366677,0.0728076503096879
Vermont,2020-04-09,23,0,628,23,623989,2020-04-03,1.20578781296528,0.0706845334160594
Vermont,2020-04-10,51,1,679,24,623989,2020-04-04,1.16329990674527,0.0681938482435159
Vermont,2020-04-11,32,1,711,25,623989,2020-04-05,0.974740425988945,0.061525070135739
Vermont,2020-04-12,16,2,727,27,623989,2020-04-06,0.844000878909104,0.0574269859941066
Vermont,2020-04-13,21,1,748,28,623989,2020-04-07,0.836632264807876,0.0582909319713214
Vermont,2020-04-14,4,1,752,29,623989,2020-04-08,0.753841016995588,0.0565027730703061
Vermont,2020-04-15,7,0,759,29,623989,2020-04-09,0.692503377899256,0.0556232098458954
Vermont,2020-04-16,15,4,774,33,623989,2020-04-10,0.703110313798717,0.0579915612773845
Vermont,2020-04-17,5,2,779,35,623989,2020-04-11,0.516019956792161,0.0513459047898752
Vermont,2020-04-18,24,3,803,38,623989,2020-04-12,0.524807170131778,0.0544199684474826
Vermont,2020-04-19,10,0,813,38,623989,2020-04-13,0.546840074116312,0.0586274098011726
Vermont,2020-04-20,3,0,816,38,623989,2020-04-14,0.477067745504306,0.0574322075222405
Vermont,2020-04-21,2,2,818,40,623989,2020-04-15,0.515135157790083,0.0629337759956121
Vermont,2020-04-22,5,0,823,40,623989,2020-04-16,0.553410530799798,0.068642128306626
Vermont,2020-04-23,2,3,825,43,623989,2020-04-17,0.483745415944042,0.0670834192868037
Vermont,2020-04-24,2,1,827,44,623989,2020-04-18,0.504123358759211,0.0720176226798873
Vermont,2020-04-25,16,2,843,46,623989,2020-04-19,0.466968684391111,0.072928256125533
Vermont,2020-04-26,8,0,851,46,623989,2020-04-20,0.493621152438968,0.0790426438191914
Vermont,2020-04-27,4,1,855,47,623989,2020-04-21,0.560901447568296,0.0886863058600665
Vermont,2020-04-28,7,0,862,47,623989,2020-04-22,0.687459074909862,0.102480348216505
Vermont,2020-04-29,0,0,862,47,623989,2020-04-23,0.647210110128925,0.102332903634791
Vermont,2020-04-30,4,2,866,49,623989,2020-04-24,0.722253829116045,0.111446185355554
Vermont,2020-05-01,13,1,879,50,623989,2020-04-25,0.961485163791229,0.132070144326661
Vermont,2020-05-02,7,1,886,51,623989,2020-04-26,0.801886390172874,0.120888921849816
Vermont,2020-05-03,11,2,897,53,623989,2020-04-27,0.878853575560563,0.128193969327036
Vermont,2020-05-04,5,-1,902,52,623989,2020-04-28,0.922002339176975,0.133079574679323
Vermont,2020-05-05,5,0,907,52,623989,2020-04-29,0.894912543078191,0.131947655939002
Vermont,2020-05-06,1,0,908,52,623989,2020-04-30,0.93137304909594,0.135854721887747
Vermont,2020-05-07,8,1,916,53,623989,2020-05-01,1.02577330555972,0.143636993050285
Vermont,2020-05-08,3,0,919,53,623989,2020-05-02,0.821159895767057,0.128243630033997
Vermont,2020-05-09,2,0,921,53,623989,2020-05-03,0.743468309173433,0.123911384862239
Vermont,2020-05-10,6,0,927,53,623989,2020-05-04,0.679216257150067,0.121990841006933
Virgin Islands,2020-03-08,0,0,0,0,107268,2020-03-02,5,5
Virgin Islands,2020-03-09,0,0,0,0,107268,2020-03-03,5,5
Virgin Islands,2020-03-10,0,0,0,0,107268,2020-03-04,5,5
Virgin Islands,2020-03-11,0,0,0,0,107268,2020-03-05,5,5
Virgin Islands,2020-03-12,0,0,0,0,107268,2020-03-06,5,5
Virgin Islands,2020-03-13,0,0,0,0,107268,2020-03-07,5,5
Virgin Islands,2020-03-14,0,0,0,0,107268,2020-03-08,5,5
Virgin Islands,2020-03-15,0,0,0,0,107268,2020-03-09,5,5
Virgin Islands,2020-03-16,1,0,1,0,107268,2020-03-10,10,7.07106781186548
Virgin Islands,2020-03-17,1,0,2,0,107268,2020-03-11,7.81847105031648,4.51399636555151
Virgin Islands,2020-03-18,0,0,2,0,107268,2020-03-12,3.91918842154543,2.26274449018412
Virgin Islands,2020-03-19,1,0,3,0,107268,2020-03-13,3.66414805088902,1.83207402544451
Virgin Islands,2020-03-20,0,0,3,0,107268,2020-03-14,2.66926748642664,1.33463374321332
Virgin Islands,2020-03-21,3,0,6,0,107268,2020-03-15,3.75306801070696,1.41852637283464
Virgin Islands,2020-03-22,0,0,6,0,107268,2020-03-16,2.61577023376363,0.988668217917692
Virgin Islands,2020-03-23,1,0,7,0,107268,2020-03-17,2.01727080375839,0.762456696259442
Virgin Islands,2020-03-24,10,0,17,0,107268,2020-03-18,3.98769115585511,0.996922788963778
Virgin Islands,2020-03-25,0,0,17,0,107268,2020-03-19,2.63269199195443,0.658172997988607
Virgin Islands,2020-03-26,0,0,17,0,107268,2020-03-20,1.83306595567927,0.473295594589706
Virgin Islands,2020-03-27,2,0,19,0,107268,2020-03-21,1.80645929285894,0.438130733696234
Virgin Islands,2020-03-28,3,0,22,0,107268,2020-03-22,1.59718514479784,0.38737429739229
Virgin Islands,2020-03-29,1,0,23,0,107268,2020-03-23,1.53282910386482,0.361291284580971
Virgin Islands,2020-03-30,7,0,30,0,107268,2020-03-24,1.88233513413722,0.384230050295794
Virgin Islands,2020-03-31,0,0,30,0,107268,2020-03-25,0.952336992821912,0.254522767420728
Virgin Islands,2020-04-01,0,0,30,0,107268,2020-03-26,0.952207327259404,0.254488112841459
Virgin Islands,2020-04-02,0,0,30,0,107268,2020-03-27,0.999264511049542,0.267064674222112
Virgin Islands,2020-04-03,7,0,37,0,107268,2020-03-28,1.38491261675217,0.3177207443188
Virgin Islands,2020-04-04,3,0,40,0,107268,2020-03-29,1.31292340619237,0.301205286747461
Virgin Islands,2020-04-05,2,1,42,1,107268,2020-03-30,1.30235469869846,0.291215363710602
Virgin Islands,2020-04-06,1,0,43,1,107268,2020-03-31,0.868956999545452,0.232238526867012
Virgin Islands,2020-04-07,0,0,43,1,107268,2020-04-01,0.895485433072042,0.239328548957319
Virgin Islands,2020-04-08,2,0,45,1,107268,2020-04-02,1.073297190564,0.268324297641
Virgin Islands,2020-04-09,0,0,45,1,107268,2020-04-03,1.07619782351175,0.269049455877938
Virgin Islands,2020-04-10,5,0,50,1,107268,2020-04-04,0.93446346948124,0.249745867375349
Virgin Islands,2020-04-11,1,0,51,1,107268,2020-04-05,0.81837178557413,0.236243585349209
Virgin Islands,2020-04-12,0,0,51,1,107268,2020-04-06,0.717798645376153,0.226987862077213
Virgin Islands,2020-04-13,0,0,51,1,107268,2020-04-07,0.695770323116336,0.231923441038779
Virgin Islands,2020-04-14,0,0,51,1,107268,2020-04-08,0.754538097389606,0.251512699129869
Virgin Islands,2020-04-15,0,0,51,1,107268,2020-04-09,0.627712280737583,0.237252941390401
Virgin Islands,2020-04-16,0,0,51,1,107268,2020-04-10,0.685250423551502,0.259000315216993
Virgin Islands,2020-04-17,0,1,51,2,107268,2020-04-11,0.213264259243011,0.150800603895459
Virgin Islands,2020-04-18,2,1,53,3,107268,2020-04-12,0.381995179623946,0.220545019785024
Virgin Islands,2020-04-19,0,0,53,3,107268,2020-04-13,0.456207113347892,0.263391299697627
Virgin Islands,2020-04-20,0,0,53,3,107268,2020-04-14,0.520963217942252,0.300778254116853
Virgin Islands,2020-04-21,0,0,53,3,107268,2020-04-15,0.587137569390874,0.338984033739164
Virgin Islands,2020-04-22,1,0,54,3,107268,2020-04-16,0.871180670639074,0.435590335319537
Virgin Islands,2020-04-23,0,0,54,3,107268,2020-04-17,0.918018963419892,0.459009481709946
Virgin Islands,2020-04-24,0,0,54,3,107268,2020-04-18,0.948904733241774,0.474452366620887
Virgin Islands,2020-04-25,1,0,55,3,107268,2020-04-19,0.737909246292328,0.42603210198439
Virgin Islands,2020-04-26,2,1,57,4,107268,2020-04-20,1.33387812141712,0.596528430637681
Virgin Islands,2020-04-27,0,0,57,4,107268,2020-04-21,1.31473921255158,0.587969250389974
Virgin Islands,2020-04-28,0,0,57,4,107268,2020-04-22,1.2583602022827,0.562755790496899
Virgin Islands,2020-04-29,0,0,57,4,107268,2020-04-23,0.987109816310632,0.493554908155316
Virgin Islands,2020-04-30,9,0,66,4,107268,2020-04-24,3.32005513667831,0.920817617897019
Virgin Islands,2020-05-01,0,0,66,4,107268,2020-04-25,2.40680260657654,0.6675269390717
Virgin Islands,2020-05-02,0,0,66,4,107268,2020-04-26,1.69582140211134,0.489541471503255
Virgin Islands,2020-05-03,0,0,66,4,107268,2020-04-27,1.25549381220386,0.397022003481189
Virgin Islands,2020-05-04,0,0,66,4,107268,2020-04-28,1.22080818424121,0.386053444837669
Virgin Islands,2020-05-05,0,0,66,4,107268,2020-04-29,1.2080591527976,0.382021847105378
Virgin Islands,2020-05-06,0,0,66,4,107268,2020-04-30,1.18930212924205,0.376090355449282
Virgin Islands,2020-05-07,0,0,66,4,107268,2020-05-01,0.117228812055917,0.117228812055917
Virgin Islands,2020-05-08,2,0,68,4,107268,2020-05-02,0.429593695170311,0.248026035548745
Virgin Islands,2020-05-09,0,0,68,4,107268,2020-05-03,0.530139996545824,0.306076469713919
Virgin Islands,2020-05-10,1,0,69,4,107268,2020-05-04,0.803521841777386,0.401760920888693
Virginia,2020-03-08,2,0,2,0,8535519,2020-03-02,15,8.66025403784439
Virginia,2020-03-09,0,0,2,0,8535519,2020-03-03,5.28714977316387,3.05253734478203
Virginia,2020-03-10,6,0,8,0,8535519,2020-03-04,9.34079196520022,3.11359732173341
Virginia,2020-03-11,1,0,9,0,8535519,2020-03-05,4.30655325695256,1.36185171567864
Virginia,2020-03-12,3,0,12,0,8535519,2020-03-06,3.34696558783504,0.928281234165592
Virginia,2020-03-13,15,0,27,0,8535519,2020-03-07,5.04578238271673,0.953563239601386
Virginia,2020-03-14,10,1,37,1,8535519,2020-03-08,3.91205509097678,0.634619136400088
Virginia,2020-03-15,0,0,37,1,8535519,2020-03-09,2.31731232098349,0.386218720163915
Virginia,2020-03-16,12,1,49,2,8535519,2020-03-10,2.41771370840876,0.348966915093312
Virginia,2020-03-17,18,0,67,2,8535519,2020-03-11,2.40108667726178,0.309978957127846
Virginia,2020-03-18,12,0,79,2,8535519,2020-03-12,2.22818720203573,0.264437170239829
Virginia,2020-03-19,24,0,103,2,8535519,2020-03-13,2.32202994791283,0.242088357006012
Virginia,2020-03-20,20,0,123,2,8535519,2020-03-14,1.94786713487698,0.197775942558716
Virginia,2020-03-21,34,1,157,3,8535519,2020-03-15,2.03382535168756,0.184893213789778
Virginia,2020-03-22,63,3,220,6,8535519,2020-03-16,2.58510610230211,0.190576550295692
Virginia,2020-03-23,34,0,254,6,8535519,2020-03-17,2.21506856936333,0.154331140119513
Virginia,2020-03-24,39,3,293,9,8535519,2020-03-18,1.94153823932647,0.128864418980374
Virginia,2020-03-25,103,0,396,9,8535519,2020-03-19,2.2886117711968,0.128338975281444
Virginia,2020-03-26,70,1,466,10,8535519,2020-03-20,2.10163809003358,0.110155767102971
Virginia,2020-03-27,141,0,607,10,8535519,2020-03-21,2.2795069597652,0.103507079090721
Virginia,2020-03-28,133,3,740,13,8535519,2020-03-22,2.19521206942482,0.0908385217693484
Virginia,2020-03-29,150,7,890,20,8535519,2020-03-23,2.02759102576695,0.0782742833841394
Virginia,2020-03-30,130,-5,1020,15,8535519,2020-03-24,1.91881355929933,0.0692843419979573
Virginia,2020-03-31,229,12,1249,27,8535519,2020-03-25,2.02387439142049,0.0654225678553951
Virginia,2020-04-01,234,7,1483,34,8535519,2020-03-26,1.91694481929586,0.0581159262385102
Virginia,2020-04-02,223,7,1706,41,8535519,2020-03-27,1.84297063010197,0.0523157581643561
Virginia,2020-04-03,306,5,2012,46,8535519,2020-03-28,1.78829081256911,0.0476919944786706
Virginia,2020-04-04,395,6,2407,52,8535519,2020-03-29,1.83463233802735,0.0449211660635942
Virginia,2020-04-05,233,0,2640,52,8535519,2020-03-30,1.65468252645043,0.0395431814612858
Virginia,2020-04-06,238,14,2878,66,8535519,2020-03-31,1.54944826818751,0.0359366331303772
Virginia,2020-04-07,457,0,3335,66,8535519,2020-04-01,1.57173020116146,0.0344046206631061
Virginia,2020-04-08,310,0,3645,66,8535519,2020-04-02,1.46831436971841,0.0315711781831646
Virginia,2020-04-09,397,43,4042,109,8535519,2020-04-03,1.45085079986032,0.0300118935449416
Virginia,2020-04-10,467,12,4509,121,8535519,2020-04-04,1.4280805302668,0.0285730421089378
Virginia,2020-04-11,568,9,5077,130,8535519,2020-04-05,1.40973486762341,0.027277244559476
Virginia,2020-04-12,197,11,5274,141,8535519,2020-04-06,1.28833137541679,0.0250978935959539
Virginia,2020-04-13,473,8,5747,149,8535519,2020-04-07,1.32736336494961,0.0247770090028146
Virginia,2020-04-14,435,5,6182,154,8535519,2020-04-08,1.24321036717744,0.0232956391571918
Virginia,2020-04-15,318,41,6500,195,8535519,2020-04-09,1.18911093696163,0.0222506791858206
Virginia,2020-04-16,389,13,6889,208,8535519,2020-04-10,1.14639929878966,0.0214815650671371
Virginia,2020-04-17,602,23,7491,231,8535519,2020-04-11,1.17029159510804,0.0214273004526172
Virginia,2020-04-18,562,27,8053,258,8535519,2020-04-12,1.13399517821348,0.0207836485834865
Virginia,2020-04-19,489,19,8542,277,8535519,2020-04-13,1.21389663606628,0.0212311856361288
Virginia,2020-04-20,448,23,8990,300,8535519,2020-04-14,1.15969739927013,0.0203612417550051
Virginia,2020-04-21,640,24,9630,324,8535519,2020-04-15,1.19299974122264,0.0203139206780281
Virginia,2020-04-22,636,25,10266,349,8535519,2020-04-16,1.25817405757295,0.020499483370633
Virginia,2020-04-23,732,24,10998,373,8535519,2020-04-17,1.30705653469336,0.0203879453964879
Virginia,2020-04-24,596,38,11594,411,8535519,2020-04-18,1.22950123990274,0.0191922236102501
Virginia,2020-04-25,772,26,12366,437,8535519,2020-04-19,1.23313318756891,0.0187745664024095
Virginia,2020-04-26,604,12,12970,449,8535519,2020-04-20,1.21264998341841,0.0182214370504494
Virginia,2020-04-27,568,11,13538,460,8535519,2020-04-21,1.19566001768635,0.0177275916154203
Virginia,2020-04-28,801,32,14339,492,8535519,2020-04-22,1.19315696577023,0.0173854976838966
Virginia,2020-04-29,623,30,14962,522,8535519,2020-04-23,1.14759400955519,0.0167447239585661
Virginia,2020-04-30,885,30,15847,552,8535519,2020-04-24,1.1518029291135,0.016538926201537
Virginia,2020-05-01,1055,29,16902,581,8535519,2020-04-25,1.22689754214295,0.0168384431025329
Virginia,2020-05-02,836,36,17738,617,8535519,2020-04-26,1.19080074049056,0.0162454099720974
Virginia,2020-05-03,934,43,18672,660,8535519,2020-04-27,1.2157086532268,0.016098218663567
Virginia,2020-05-04,821,24,19493,684,8535519,2020-04-28,1.21950593833933,0.0158018005156824
Virginia,2020-05-05,764,29,20257,713,8535519,2020-04-29,1.16133981713473,0.0150950705217583
Virginia,2020-05-06,728,24,20985,737,8535519,2020-04-30,1.1447739641133,0.0147494987698824
Virginia,2020-05-07,585,32,21570,769,8535519,2020-05-01,1.05957340420291,0.0140049394731315
Virginia,2020-05-08,772,43,22342,812,8535519,2020-05-02,0.995858958520474,0.0135007679147826
Virginia,2020-05-09,854,15,23196,827,8535519,2020-05-03,1.00300468272653,0.01357520552652
Virginia,2020-05-10,885,12,24081,839,8535519,2020-05-04,0.997435522332373,0.0135608277137826
Washington,2020-03-08,20,2,122,18,7614893,2020-03-02,2.4820315446812,0.234529936194427
Washington,2020-03-09,0,1,122,19,7614893,2020-03-03,1.78964498101866,0.174651466752809
Washington,2020-03-10,45,4,167,23,7614893,2020-03-04,2.06826327650722,0.174179189158189
Washington,2020-03-11,115,1,282,24,7614893,2020-03-05,2.99985920481631,0.192046306411329
Washington,2020-03-12,160,7,442,31,7614893,2020-03-06,3.31037518661765,0.171404729915669
Washington,2020-03-13,126,6,568,37,7614893,2020-03-07,2.96416795207863,0.133771027036497
Washington,2020-03-14,74,2,642,39,7614893,2020-03-08,2.32243131471329,0.0998491210349994
Washington,2020-03-15,-39,1,603,40,7614893,2020-03-09,1.75252326599154,0.0767794382993873
Washington,2020-03-16,176,8,779,48,7614893,2020-03-10,2.03282846380193,0.0769988686425234
Washington,2020-03-17,176,7,955,55,7614893,2020-03-11,2.02981146337733,0.0705408246554096
Washington,2020-03-18,67,12,1022,67,7614893,2020-03-12,1.58234133174809,0.0566569081736087
Washington,2020-03-19,352,6,1374,73,7614893,2020-03-13,1.75588433594946,0.0563200163347927
Washington,2020-03-20,150,10,1524,83,7614893,2020-03-14,1.58144325016302,0.0501099469228277
Washington,2020-03-21,269,11,1793,94,7614893,2020-03-15,1.68863958677625,0.0489306613193797
Washington,2020-03-22,204,3,1997,97,7614893,2020-03-16,1.75006751908308,0.0468562686070656
Washington,2020-03-23,224,12,2221,109,7614893,2020-03-17,1.57508328426435,0.0414639199117541
Washington,2020-03-24,107,7,2328,116,7614893,2020-03-18,1.34127855942777,0.0361847532970027
Washington,2020-03-25,263,17,2591,133,7614893,2020-03-19,1.43600771121121,0.0362415652093943
Washington,2020-03-26,616,17,3207,150,7614893,2020-03-20,1.55714198187648,0.0363603912846681
Washington,2020-03-27,270,7,3477,157,7614893,2020-03-21,1.49686886414455,0.0338626915867172
Washington,2020-03-28,553,31,4030,188,7614893,2020-03-22,1.55661332120461,0.0329041519184522
Washington,2020-03-29,435,10,4465,198,7614893,2020-03-23,1.54983933424103,0.0311907727081375
Washington,2020-03-30,458,7,4923,205,7614893,2020-03-24,1.52818807599849,0.0293936679530157
Washington,2020-03-31,509,20,5432,225,7614893,2020-03-25,1.58876319981149,0.0285120451144842
Washington,2020-04-01,176,9,5608,234,7614893,2020-03-26,1.38469996784089,0.0252055433812352
Washington,2020-04-02,781,37,6389,271,7614893,2020-03-27,1.35149432135796,0.0239549851478716
Washington,2020-04-03,457,20,6846,291,7614893,2020-03-28,1.34398610493281,0.0231515369849033
Washington,2020-04-04,401,24,7247,315,7614893,2020-03-29,1.20450008795592,0.0212331200963506
Washington,2020-04-05,578,21,7825,336,7614893,2020-03-30,1.20904559889124,0.0208549150076351
Washington,2020-04-06,486,45,8311,381,7614893,2020-03-31,1.17719875945615,0.0202215299668541
Washington,2020-04-07,381,19,8692,400,7614893,2020-04-01,1.09639002745242,0.0191994893201748
Washington,2020-04-08,584,26,9276,426,7614893,2020-04-02,1.21255615365629,0.0200183373673706
Washington,2020-04-09,363,30,9639,456,7614893,2020-04-03,1.03705955377005,0.0181884299578809
Washington,2020-04-10,480,27,10119,483,7614893,2020-04-04,1.03265153904186,0.0180473923129959
Washington,2020-04-11,315,12,10434,495,7614893,2020-04-05,1.00527374674227,0.0178043115213195
Washington,2020-04-12,175,11,10609,506,7614893,2020-04-06,0.879084755738574,0.0166578193991695
Washington,2020-04-13,26,7,10635,513,7614893,2020-04-07,0.752578647181199,0.0156077540722495
Washington,2020-04-14,164,17,10799,530,7614893,2020-04-08,0.720618930397174,0.0156953268230676
Washington,2020-04-15,143,22,10942,552,7614893,2020-04-09,0.607435555210098,0.0148775839348764
Washington,2020-04-16,115,27,11057,579,7614893,2020-04-10,0.561922017277204,0.0149171154613188
Washington,2020-04-17,460,24,11517,603,7614893,2020-04-11,0.609990172990656,0.0163084986230341
Washington,2020-04-18,259,10,11776,613,7614893,2020-04-12,0.636951581322395,0.0173807460368947
Washington,2020-04-19,202,23,11978,636,7614893,2020-04-13,0.69860231175859,0.0188742513748082
Washington,2020-04-20,136,7,12114,643,7614893,2020-04-14,0.800473266261179,0.0208073117670734
Washington,2020-04-21,278,21,12392,664,7614893,2020-04-15,0.89387931158028,0.0223890015971338
Washington,2020-04-22,204,22,12596,686,7614893,2020-04-16,0.942176672194872,0.0231597223244133
Washington,2020-04-23,157,25,12753,711,7614893,2020-04-17,0.970741943054303,0.0235647520002344
Washington,2020-04-24,224,11,12977,722,7614893,2020-04-18,0.836261816844663,0.0218784806764394
Washington,2020-04-25,342,15,13319,737,7614893,2020-04-19,0.907652441797091,0.0230991464512167
Washington,2020-04-26,202,12,13521,749,7614893,2020-04-20,0.927575630602566,0.0236061782563443
Washington,2020-04-27,165,15,13686,764,7614893,2020-04-21,0.956003388472671,0.0241043303262625
Washington,2020-04-28,156,22,13842,786,7614893,2020-04-22,0.888088045136748,0.0233142966274518
Washington,2020-04-29,228,15,14070,801,7614893,2020-04-23,0.920083423382309,0.0239569317803302
Washington,2020-04-30,257,13,14327,814,7614893,2020-04-24,0.999750780345796,0.0251913517889308
Washington,2020-05-01,310,10,14637,824,7614893,2020-04-25,1.05398792631981,0.0258613278359803
Washington,2020-05-02,366,6,15003,830,7614893,2020-04-26,1.05507592834225,0.0257029967951903
Washington,2020-05-03,182,4,15185,834,7614893,2020-04-27,1.02806847646792,0.0251950325470973
Washington,2020-05-04,277,7,15462,841,7614893,2020-04-28,1.08916354015423,0.02583743404176
Washington,2020-05-05,132,21,15594,862,7614893,2020-04-29,1.05676996863174,0.0252400089703795
Washington,2020-05-06,311,8,15905,870,7614893,2020-04-30,1.09161069631917,0.0254760119594613
Washington,2020-05-07,326,21,16231,891,7614893,2020-05-01,1.1134671465824,0.0255111430186863
Washington,2020-05-08,157,14,16388,905,7614893,2020-05-02,1.00070902952402,0.0239078634989379
Washington,2020-05-09,286,16,16674,921,7614893,2020-05-03,0.952471863611258,0.0232934608327412
Washington,2020-05-10,217,10,16891,931,7614893,2020-05-04,0.984474650384302,0.0238280101951252
West Virginia,2020-03-08,0,0,0,0,1792147,2020-03-02,5,5
West Virginia,2020-03-09,0,0,0,0,1792147,2020-03-03,5,5
West Virginia,2020-03-10,0,0,0,0,1792147,2020-03-04,5,5
West Virginia,2020-03-11,0,0,0,0,1792147,2020-03-05,5,5
West Virginia,2020-03-12,0,0,0,0,1792147,2020-03-06,5,5
West Virginia,2020-03-13,0,0,0,0,1792147,2020-03-07,5,5
West Virginia,2020-03-14,0,0,0,0,1792147,2020-03-08,5,5
West Virginia,2020-03-15,0,0,0,0,1792147,2020-03-09,5,5
West Virginia,2020-03-16,0,0,0,0,1792147,2020-03-10,5,5
West Virginia,2020-03-17,0,0,0,0,1792147,2020-03-11,5,5
West Virginia,2020-03-18,1,0,1,0,1792147,2020-03-12,10,7.07106781186548
West Virginia,2020-03-19,1,0,2,0,1792147,2020-03-13,7.81847105031648,4.51399636555151
West Virginia,2020-03-20,6,0,8,0,1792147,2020-03-14,11.7575652646363,3.91918842154543
West Virginia,2020-03-21,4,0,12,0,1792147,2020-03-15,5.92552249969907,1.64344424666004
West Virginia,2020-03-22,4,0,16,0,1792147,2020-03-16,3.91686489913476,0.949979276494523
West Virginia,2020-03-23,0,0,16,0,1792147,2020-03-17,2.49829243608781,0.605924917510099
West Virginia,2020-03-24,6,0,22,0,1792147,2020-03-18,2.61029210126102,0.544283528012252
West Virginia,2020-03-25,17,0,39,0,1792147,2020-03-19,3.43548431264145,0.550117760409614
West Virginia,2020-03-26,13,0,52,0,1792147,2020-03-20,3.07466129145155,0.430538697155145
West Virginia,2020-03-27,24,0,76,0,1792147,2020-03-21,2.92319928802641,0.351911840028772
West Virginia,2020-03-28,20,0,96,0,1792147,2020-03-22,2.60660036366937,0.282725505120536
West Virginia,2020-03-29,17,0,113,0,1792147,2020-03-23,2.26952200978595,0.229256343310252
West Virginia,2020-03-30,32,1,145,1,1792147,2020-03-24,2.39972308588959,0.210469637659567
West Virginia,2020-03-31,17,0,162,1,1792147,2020-03-25,2.04767296494298,0.172445172114271
West Virginia,2020-04-01,29,0,191,1,1792147,2020-03-26,1.82776110444168,0.147765727294287
West Virginia,2020-04-02,25,1,216,2,1792147,2020-03-27,1.69654889474879,0.132076152328033
West Virginia,2020-04-03,21,0,237,2,1792147,2020-03-28,1.46842505656402,0.115370368351185
West Virginia,2020-04-04,45,0,282,2,1792147,2020-03-29,1.55396152837255,0.11363692138533
West Virginia,2020-04-05,42,1,324,3,1792147,2020-03-30,1.60205500318469,0.110029589357134
West Virginia,2020-04-06,21,1,345,4,1792147,2020-03-31,1.35986633243366,0.0959175755735792
West Virginia,2020-04-07,67,0,412,4,1792147,2020-04-01,1.58123178332641,0.0998064651635989
West Virginia,2020-04-08,71,0,483,4,1792147,2020-04-02,1.67212786146724,0.0976867527130179
West Virginia,2020-04-09,31,1,514,5,1792147,2020-04-03,1.50369523871774,0.0869609409677007
West Virginia,2020-04-10,60,0,574,5,1792147,2020-04-04,1.53954817504456,0.0837403811182603
West Virginia,2020-04-11,3,0,577,5,1792147,2020-04-05,1.2230900601808,0.0710906657335269
West Virginia,2020-04-12,16,1,593,6,1792147,2020-04-06,1.06417444371553,0.0647635942159454
West Virginia,2020-04-13,18,2,611,8,1792147,2020-04-07,1.04757830453693,0.0641107510875165
West Virginia,2020-04-14,29,1,640,9,1792147,2020-04-08,0.898280122519853,0.0593600213380196
West Virginia,2020-04-15,62,1,702,10,1792147,2020-04-09,0.883771001868136,0.0595838287908499
West Virginia,2020-04-16,26,2,728,12,1792147,2020-04-10,0.892091651854334,0.060840145685352
West Virginia,2020-04-17,47,4,775,16,1792147,2020-04-11,0.860814334461081,0.0605666852195457
West Virginia,2020-04-18,10,0,785,16,1792147,2020-04-12,0.918139837674417,0.0635090605571044
West Virginia,2020-04-19,105,2,890,18,1792147,2020-04-13,1.33608318793678,0.0773972209819526
West Virginia,2020-04-20,12,6,902,24,1792147,2020-04-14,1.23405423050065,0.0722175614200168
West Virginia,2020-04-21,6,2,908,26,1792147,2020-04-15,1.07224011736102,0.0653756337769749
West Virginia,2020-04-22,31,1,939,27,1792147,2020-04-16,0.933108752843128,0.0604844568072032
West Virginia,2020-04-23,42,4,981,31,1792147,2020-04-17,1.01173900239082,0.0634821510334812
West Virginia,2020-04-24,29,1,1010,32,1792147,2020-04-18,0.945089197409694,0.0615200666952545
West Virginia,2020-04-25,0,0,1010,32,1792147,2020-04-19,0.914223751599029,0.0608132593536999
West Virginia,2020-04-26,45,2,1055,34,1792147,2020-04-20,0.685254006057582,0.0531860257043963
West Virginia,2020-04-27,8,0,1063,34,1792147,2020-04-21,0.712749510353167,0.0559988902286795
West Virginia,2020-04-28,32,4,1095,38,1792147,2020-04-22,0.886904230259544,0.0646841390031276
West Virginia,2020-04-29,15,0,1110,38,1792147,2020-04-23,0.833965540781595,0.0635892763379254
West Virginia,2020-04-30,15,3,1125,41,1792147,2020-04-24,0.722589247791081,0.0600077708199634
West Virginia,2020-05-01,27,5,1152,46,1792147,2020-04-25,0.753284197607885,0.0629927891514196
West Virginia,2020-05-02,33,2,1185,48,1792147,2020-04-26,0.979069934599257,0.0738001731041712
West Virginia,2020-05-03,10,0,1195,48,1792147,2020-04-27,0.789802810716226,0.0665133954308406
West Virginia,2020-05-04,29,0,1224,48,1792147,2020-04-28,0.936196941043674,0.0735545783931205
West Virginia,2020-05-05,22,0,1246,48,1792147,2020-04-29,0.895319432217989,0.0726199953301948
West Virginia,2020-05-06,-4,2,1242,50,1792147,2020-04-30,0.819425852423151,0.0700082751948804
West Virginia,2020-05-07,45,1,1287,51,1792147,2020-05-01,1.03494417079061,0.0800863843733549
West Virginia,2020-05-08,36,1,1323,52,1792147,2020-05-02,1.08906724362561,0.0820915322402894
West Virginia,2020-05-09,0,0,1323,52,1792147,2020-05-03,0.864348307681859,0.0722804366162105
West Virginia,2020-05-10,37,2,1360,54,1792147,2020-05-04,1.04881393314408,0.0804403566536819
Wisconsin,2020-03-08,0,0,0,0,5822434,2020-03-02,5,5
Wisconsin,2020-03-09,0,0,0,0,5822434,2020-03-03,5,5
Wisconsin,2020-03-10,3,0,3,0,5822434,2020-03-04,20,10
Wisconsin,2020-03-11,1,0,4,0,5822434,2020-03-05,6.65672413710444,2.97697753560583
Wisconsin,2020-03-12,4,0,8,0,5822434,2020-03-06,5.88627584847887,1.96209194949296
Wisconsin,2020-03-13,11,0,19,0,5822434,2020-03-07,7.02669570482446,1.57121692531933
Wisconsin,2020-03-14,8,0,27,0,5822434,2020-03-08,4.61095209092553,0.87138803855873
Wisconsin,2020-03-15,1,0,28,0,5822434,2020-03-09,2.7491064895634,0.510496259264203
Wisconsin,2020-03-16,20,0,48,0,5822434,2020-03-10,3.41352471012105,0.48764638716015
Wisconsin,2020-03-17,25,0,73,0,5822434,2020-03-11,3.41519639528572,0.405309244105485
Wisconsin,2020-03-18,38,0,111,0,5822434,2020-03-12,3.49723331380993,0.336521432524515
Wisconsin,2020-03-19,48,4,159,4,5822434,2020-03-13,3.28733735711641,0.266638268903834
Wisconsin,2020-03-20,60,-1,219,3,5822434,2020-03-14,2.96996326891172,0.209485057098796
Wisconsin,2020-03-21,63,1,282,4,5822434,2020-03-15,2.70177813219978,0.168861133262486
Wisconsin,2020-03-22,99,0,381,4,5822434,2020-03-16,2.7796293836904,0.147735634925246
Wisconsin,2020-03-23,44,1,425,5,5822434,2020-03-17,2.19325356082055,0.112808790583633
Wisconsin,2020-03-24,56,0,481,5,5822434,2020-03-18,1.89691140273303,0.0937962322166542
Wisconsin,2020-03-25,140,2,621,7,5822434,2020-03-19,2.01455357384434,0.0891186032431489
Wisconsin,2020-03-26,107,3,728,10,5822434,2020-03-20,1.88221324072522,0.0788372372116135
Wisconsin,2020-03-27,198,4,926,14,5822434,2020-03-21,1.98370017108557,0.0745520177172501
Wisconsin,2020-03-28,129,3,1055,17,5822434,2020-03-22,1.82035532321693,0.065431320906041
Wisconsin,2020-03-29,109,1,1164,18,5822434,2020-03-23,1.57909914561923,0.0563963980578295
Wisconsin,2020-03-30,66,2,1230,20,5822434,2020-03-24,1.45485930028062,0.0512452331937145
Wisconsin,2020-03-31,182,5,1412,25,5822434,2020-03-25,1.54941664656637,0.0507528297341814
Wisconsin,2020-04-01,144,2,1556,27,5822434,2020-03-26,1.41214388004726,0.0461573666689845
Wisconsin,2020-04-02,192,11,1748,38,5822434,2020-03-27,1.42145847731686,0.0444857899456347
Wisconsin,2020-04-03,264,13,2012,51,5822434,2020-03-28,1.40316761502329,0.0425593298293089
Wisconsin,2020-04-04,18,3,2030,54,5822434,2020-03-29,1.16823508690111,0.0373942938887383
Wisconsin,2020-04-05,290,20,2320,74,5822434,2020-03-30,1.33843196478697,0.039348630398395
Wisconsin,2020-04-06,129,4,2449,78,5822434,2020-03-31,1.33651867606321,0.0382644183846587
Wisconsin,2020-04-07,129,14,2578,92,5822434,2020-04-01,1.19653383480588,0.0350259203546218
Wisconsin,2020-04-08,132,8,2710,100,5822434,2020-04-02,1.13875948580661,0.0335074220183472
Wisconsin,2020-04-09,176,11,2886,111,5822434,2020-04-03,1.0975037916566,0.0325195230441227
Wisconsin,2020-04-10,182,17,3068,128,5822434,2020-04-04,1.00266210076555,0.0308401943235521
Wisconsin,2020-04-11,145,9,3213,137,5822434,2020-04-05,1.12522581860366,0.0327012111165641
Wisconsin,2020-04-12,128,7,3341,144,5822434,2020-04-06,0.954458014473036,0.0298559834364691
Wisconsin,2020-04-13,87,10,3428,154,5822434,2020-04-07,0.919926973377749,0.0293859892401184
Wisconsin,2020-04-14,127,16,3555,170,5822434,2020-04-08,0.938515404088255,0.0300104133888535
Wisconsin,2020-04-15,166,13,3721,183,5822434,2020-04-09,0.986904233344144,0.031023068775312
Wisconsin,2020-04-16,154,14,3875,197,5822434,2020-04-10,0.969901156651174,0.0308254822710974
Wisconsin,2020-04-17,178,9,4053,206,5822434,2020-04-11,0.970908840622079,0.0309200365137277
Wisconsin,2020-04-18,146,6,4199,212,5822434,2020-04-12,0.978303858981537,0.0311397549264212
Wisconsin,2020-04-19,147,8,4346,220,5822434,2020-04-13,1.00186412052588,0.0315871056687679
Wisconsin,2020-04-20,153,10,4499,230,5822434,2020-04-14,1.06758519002481,0.0326065723670878
Wisconsin,2020-04-21,126,14,4625,244,5822434,2020-04-15,1.05279440787936,0.0321698350460905
Wisconsin,2020-04-22,220,4,4845,248,5822434,2020-04-16,1.09175524879084,0.0325498526811802
Wisconsin,2020-04-23,207,10,5052,258,5822434,2020-04-17,1.12329154017388,0.0327280283640721
Wisconsin,2020-04-24,304,5,5356,263,5822434,2020-04-18,1.21270824032315,0.0335828487044668
Wisconsin,2020-04-25,331,3,5687,266,5822434,2020-04-19,1.32878464950773,0.0344355682079175
Wisconsin,2020-04-26,225,6,5912,272,5822434,2020-04-20,1.31111670585524,0.0331212602264324
Wisconsin,2020-04-27,169,9,6081,281,5822434,2020-04-21,1.24228190699416,0.0312233647596493
Wisconsin,2020-04-28,208,19,6289,300,5822434,2020-04-22,1.24459747127202,0.030501541983339
Wisconsin,2020-04-29,231,8,6520,308,5822434,2020-04-23,1.19678784785964,0.0292334561743097
Wisconsin,2020-04-30,334,8,6854,316,5822434,2020-04-24,1.23902054382904,0.0291796880024316
Wisconsin,2020-05-01,460,11,7314,327,5822434,2020-04-25,1.28875915306867,0.0291175308827105
Wisconsin,2020-05-02,346,7,7660,334,5822434,2020-04-26,1.22894907575389,0.0276605182691889
Wisconsin,2020-05-03,304,5,7964,339,5822434,2020-04-27,1.22055133971543,0.0269377660648684
Wisconsin,2020-05-04,272,1,8236,340,5822434,2020-04-28,1.23026716465557,0.026495679071798
Wisconsin,2020-05-05,330,13,8566,353,5822434,2020-04-29,1.24471341756383,0.02607909469139
Wisconsin,2020-05-06,335,9,8901,362,5822434,2020-04-30,1.24237091628422,0.0254554276462528
Wisconsin,2020-05-07,314,12,9215,374,5822434,2020-05-01,1.17579917018264,0.0241931937073662
Wisconsin,2020-05-08,375,10,9590,384,5822434,2020-05-02,1.09502182877196,0.0229478108457389
Wisconsin,2020-05-09,349,14,9939,398,5822434,2020-05-03,1.07788464706381,0.0225738098555147
Wisconsin,2020-05-10,280,2,10219,400,5822434,2020-05-04,1.05420542109634,0.0221950280143755
Wyoming,2020-03-08,0,0,0,0,578759,2020-03-02,5,5
Wyoming,2020-03-09,0,0,0,0,578759,2020-03-03,5,5
Wyoming,2020-03-10,0,0,0,0,578759,2020-03-04,5,5
Wyoming,2020-03-11,0,0,0,0,578759,2020-03-05,5,5
Wyoming,2020-03-12,1,0,1,0,578759,2020-03-06,10,7.07106781186548
Wyoming,2020-03-13,0,0,1,0,578759,2020-03-07,5.21231403354432,3.68566259879299
Wyoming,2020-03-14,1,0,2,0,578759,2020-03-08,5.15678459628379,2.97727097481736
Wyoming,2020-03-15,0,0,2,0,578759,2020-03-09,3.35717744101138,1.93826729928526
Wyoming,2020-03-16,0,0,2,0,578759,2020-03-10,2.52804334421627,1.45956650530631
Wyoming,2020-03-17,9,0,11,0,578759,2020-03-11,8.64333311425298,2.49511535010478
Wyoming,2020-03-18,5,0,16,0,578759,2020-03-12,5.32099066075005,1.29052979571751
Wyoming,2020-03-19,2,0,18,0,578759,2020-03-13,2.99200398609,0.705222102633806
Wyoming,2020-03-20,3,0,21,0,578759,2020-03-14,2.48839589699252,0.543012502713607
Wyoming,2020-03-21,2,0,23,0,578759,2020-03-15,2.04428696295445,0.435843444938324
Wyoming,2020-03-22,3,0,26,0,578759,2020-03-16,1.94288495860489,0.388576991720977
Wyoming,2020-03-23,0,0,26,0,578759,2020-03-17,1.66239847892092,0.332479695784184
Wyoming,2020-03-24,3,0,29,0,578759,2020-03-18,1.12612130419314,0.258349945428744
Wyoming,2020-03-25,15,0,44,0,578759,2020-03-19,1.69238332721844,0.314267694273032
Wyoming,2020-03-26,9,0,53,0,578759,2020-03-20,1.90897772613904,0.318162954356506
Wyoming,2020-03-27,17,0,70,0,578759,2020-03-21,2.25058406375136,0.318280650621793
Wyoming,2020-03-28,12,0,82,0,578759,2020-03-22,2.17524255588216,0.280822606429775
Wyoming,2020-03-29,4,0,86,0,578759,2020-03-23,1.78529859427115,0.228584061759063
Wyoming,2020-03-30,8,0,94,0,578759,2020-03-24,1.74047639322881,0.209528735374493
Wyoming,2020-03-31,15,0,109,0,578759,2020-03-25,1.79503159602312,0.19944795511368
Wyoming,2020-04-01,21,0,130,0,578759,2020-03-26,1.67354154636454,0.179422486942925
Wyoming,2020-04-02,20,0,150,0,578759,2020-03-27,1.66338151009569,0.168026906498426
Wyoming,2020-04-03,12,0,162,0,578759,2020-03-28,1.40124053258338,0.14530187449873
Wyoming,2020-04-04,25,0,187,0,578759,2020-03-29,1.47829514331477,0.143584717309304
Wyoming,2020-04-05,10,0,197,0,578759,2020-03-30,1.44114687581171,0.136175579861267
Wyoming,2020-04-06,13,0,210,0,578759,2020-03-31,1.38684317855228,0.128213697212762
Wyoming,2020-04-07,6,0,216,0,578759,2020-04-01,1.19271999758799,0.114769535279213
Wyoming,2020-04-08,5,0,221,0,578759,2020-04-02,0.980200325822641,0.102192948298731
Wyoming,2020-04-09,9,0,230,0,578759,2020-04-03,0.87175305380617,0.0968614504229078
Wyoming,2020-04-10,9,0,239,0,578759,2020-04-04,0.870799784972439,0.0985986597862345
Wyoming,2020-04-11,22,0,261,0,578759,2020-04-05,0.868498500510513,0.100285568612106
Wyoming,2020-04-12,9,0,270,0,578759,2020-04-06,0.885305648484364,0.102914691202873
Wyoming,2020-04-13,5,1,275,1,578759,2020-04-07,0.811894732682537,0.0999373331641602
Wyoming,2020-04-14,7,0,282,1,578759,2020-04-08,0.857640728585389,0.104777491268614
Wyoming,2020-04-15,5,0,287,1,578759,2020-04-09,0.887931547784649,0.108478103819285
Wyoming,2020-04-16,9,1,296,2,578759,2020-04-10,0.909681236398951,0.111135251192217
Wyoming,2020-04-17,9,0,305,2,578759,2020-04-11,0.927326069420192,0.113290910638181
Wyoming,2020-04-18,4,0,309,2,578759,2020-04-12,0.688741345369849,0.0983916207671213
Wyoming,2020-04-19,4,0,313,2,578759,2020-04-13,0.657182034853565,0.0990739194805246
Wyoming,2020-04-20,4,0,317,2,578759,2020-04-14,0.696303231461841,0.106185247315904
Wyoming,2020-04-21,126,0,443,2,578759,2020-04-15,2.80793562286942,0.220612257785138
Wyoming,2020-04-22,4,4,447,6,578759,2020-04-16,2.10371717726151,0.165796139918375
Wyoming,2020-04-23,6,1,453,7,578759,2020-04-17,1.61885425089291,0.12878912913167
Wyoming,2020-04-24,20,0,473,7,578759,2020-04-18,1.53259845315526,0.117892188704251
Wyoming,2020-04-25,18,0,491,7,578759,2020-04-19,1.50729644779631,0.11142255958453
Wyoming,2020-04-26,11,0,502,7,578759,2020-04-20,1.42599469448146,0.103452528362918
Wyoming,2020-04-27,18,0,520,7,578759,2020-04-21,1.41372334564833,0.0989804322618404
Wyoming,2020-04-28,16,0,536,7,578759,2020-04-22,0.604222723634325,0.0623208154628798
Wyoming,2020-04-29,9,0,545,7,578759,2020-04-23,0.683760109824974,0.0687204766939891
Wyoming,2020-04-30,14,0,559,7,578759,2020-04-24,0.816859694157279,0.0789688072772522
Wyoming,2020-05-01,7,0,566,7,578759,2020-04-25,0.752415506036288,0.0776057338940389
Wyoming,2020-05-02,13,0,579,7,578759,2020-04-26,0.749192413431798,0.0794142369954554
Wyoming,2020-05-03,7,0,586,7,578759,2020-04-27,0.756566066216232,0.0820611115571735
Wyoming,2020-05-04,10,0,596,7,578759,2020-04-28,0.721916854452876,0.0822700608893784
Wyoming,2020-05-05,8,0,604,7,578759,2020-04-29,0.685123876155582,0.0824792223004187
Wyoming,2020-05-06,27,0,631,7,578759,2020-04-30,0.922860890576044,0.0989410728698147
Wyoming,2020-05-07,4,0,635,7,578759,2020-05-01,0.834171554476165,0.0950626712143361
Wyoming,2020-05-08,9,0,644,7,578759,2020-05-02,0.876592425935619,0.0986243532463556
Wyoming,2020-05-09,9,0,653,7,578759,2020-05-03,0.854716275330534,0.0986941343285676
Wyoming,2020-05-10,9,0,662,7,578759,2020-05-04,0.901767552446994,0.102765950109456
